,symbol,datetime,close,high,low,open,volume,change_in_price,down_days,up_days,RSI,low_14,high_14,k_percent,r_percent,MACD,MACD_EMA,Price_Rate_Of_Change,On Balance Volume,Prediction
2029,ARWR,1514959200000,4.64,4.88,3.77,3.79,5875479,0.9199999999999995,0.0,0.9199999999999995,82.45132371555003,3.01,4.88,87.16577540106951,-12.834224598930492,0.11497928002818014,0.06132112478406495,0.4233128834355828,10352916,1.0
2030,ARWR,1515045600000,4.85,5.13,4.5,4.58,3402024,0.20999999999999996,0.0,0.20999999999999996,84.74260263584243,3.05,5.13,86.53846153846153,-13.461538461538472,0.1640486580288436,0.08261587380615208,0.4139941690962097,13754940,1.0
2031,ARWR,1515132000000,4.87,5.23,4.66,4.86,2278246,0.020000000000000462,0.0,0.020000000000000462,84.95841964647421,3.08,5.23,83.25581395348836,-16.74418604651164,0.20043327933843758,0.10686181755789413,0.44082840236686405,16033186,1.0
2032,ARWR,1515391200000,4.55,4.9,4.37,4.88,2659533,-0.3200000000000003,0.3200000000000003,0.0,67.36637612874398,3.14,5.23,67.46411483253586,-32.53588516746414,0.2058912079403865,0.12712395848606173,0.2264150943396226,13373653,-1.0
2033,ARWR,1515477600000,4.62,4.9,4.455,4.58,1430439,0.07000000000000028,0.0,0.07000000000000028,68.98723897168503,3.2271,5.23,69.54416096659843,-30.455839033401578,0.21195702408583283,0.144401821923368,0.21899736147757265,14804092,1.0
2034,ARWR,1515564000000,4.4,4.71,4.31,4.57,1966340,-0.21999999999999975,0.21999999999999975,0.0,58.457990122256355,3.27,5.23,57.6530612244898,-42.3469387755102,0.19992784479908998,0.15566940954950256,0.14583333333333348,12837752,-1.0
2035,ARWR,1515650400000,5.04,5.47,4.37,4.44,4867172,0.6399999999999997,0.0,0.6399999999999997,72.5307789384284,3.37,5.47,79.52380952380953,-20.476190476190467,0.22996179325540123,0.1707011909307522,0.2695214105793451,17704924,1.0
2036,ARWR,1515736800000,5.72,6.25,5.0106,5.17,7345087,0.6799999999999997,0.0,0.6799999999999997,80.59133726126854,3.424,6.25,81.24557678697806,-18.754423213021948,0.29539895984955145,0.19587291287077313,0.5543478260869563,25050011,1.0
2037,ARWR,1516082400000,5.6,5.91,5.3041,5.9,2922293,-0.1200000000000001,0.1200000000000001,0.0,76.04748821873504,3.57,6.25,75.74626865671641,-24.253731343283594,0.33449217085047245,0.2238028510352388,0.5053763440860213,22127718,-1.0
2038,ARWR,1516168800000,5.72,5.86,5.37,5.59,1863618,0.1200000000000001,0.0,0.1200000000000001,77.5105487605091,3.57,6.25,80.22388059701491,-19.77611940298508,0.36899790417659606,0.253014295596903,0.23275862068965525,23991336,1.0
2039,ARWR,1516255200000,5.72,5.81,5.4,5.41,5108776,0.0,0.0,0.0,77.5105487605091,3.57,6.25,80.22388059701491,-19.77611940298508,0.3914423813536887,0.2808312747181169,0.1793814432989691,23991336,0.0
2040,ARWR,1516341600000,6.29,6.4,5.74,5.82,4723066,0.5700000000000003,0.0,0.5700000000000003,83.7771057707524,3.57,6.4,96.113074204947,-3.886925795053014,0.44391152400643286,0.3135710118054434,0.2915811088295688,28714402,1.0
2041,ARWR,1516600800000,6.39,6.75,6.27,6.31,3043385,0.09999999999999964,0.0,0.09999999999999964,84.64331095390675,3.57,6.75,88.67924528301886,-11.320754716981142,0.486575454273555,0.34827679208373646,0.4043956043956043,31757787,1.0
2042,ARWR,1516687200000,6.28,6.59,6.24,6.46,2269747,-0.10999999999999943,0.10999999999999943,0.0,79.27115954578053,3.77,6.75,84.2281879194631,-15.771812080536904,0.5063339218914615,0.37996483503186756,0.35930735930735924,29488040,-1.0
2043,ARWR,1516773600000,6.11,6.43,5.835,6.31,2069802,-0.16999999999999993,0.16999999999999993,0.0,71.21161367789301,4.31,6.75,73.7704918032787,-26.229508196721298,0.5036828641617763,0.4047563947084116,0.38863636363636367,27418238,-1.0
2044,ARWR,1516860000000,6.29,6.38,6.06,6.19,970888,0.17999999999999972,0.0,0.17999999999999972,74.39240803261426,4.31,6.75,81.14754098360656,-18.85245901639344,0.5087325093052124,0.4255838465484581,0.24801587301587302,28389126,1.0
2045,ARWR,1516946400000,6.12,6.35,6.11,6.29,768893,-0.16999999999999993,0.16999999999999993,0.0,66.39781466867687,4.31,6.75,74.18032786885247,-25.81967213114753,0.4944229360307997,0.43936872930322535,0.06993006993007,27620233,-1.0
2046,ARWR,1517205600000,6.17,6.325,6.06,6.24,923878,0.04999999999999982,0.0,0.04999999999999982,67.58016861027752,4.31,6.75,76.22950819672131,-23.770491803278688,0.48117516777727953,0.4477383058251469,0.10178571428571437,28544111,1.0
2047,ARWR,1517292000000,6.14,6.195,5.87,6.1,1338050,-0.03000000000000025,0.03000000000000025,0.0,65.97305805581723,4.31,6.75,74.99999999999999,-25.00000000000001,0.4630494820627442,0.45080296914910517,0.07342657342657333,27206061,-1.0
2048,ARWR,1517378400000,6.18,6.35,6.03,6.23,756343,0.040000000000000036,0.0,0.040000000000000036,67.17402421605867,4.37,6.75,76.0504201680672,-23.949579831932784,0.4464949795930835,0.44994082478899305,0.08041958041958042,27962404,1.0
2049,ARWR,1517464800000,6.15,6.275,6.08,6.15,769251,-0.02999999999999936,0.02999999999999936,0.0,65.18311200025667,5.0106,6.75,65.50534667126597,-34.49465332873403,0.42616635657097035,0.44518351890472463,-0.02225755166931631,27193153,-1.0
2050,ARWR,1517551200000,5.9,6.15,5.83,6.03,1353989,-0.25,0.25,0.0,50.72686840350384,5.3041,6.75,41.21308527560691,-58.78691472439309,0.3866455846877761,0.4334711809726279,-0.07668231611893572,25839164,-1.0
2051,ARWR,1517810400000,5.45,5.87,5.41,5.81,1316183,-0.4500000000000002,0.4500000000000002,0.0,34.729732939336785,5.37,6.75,5.797101449275368,-94.20289855072464,0.31743965617735537,0.4102573426923498,-0.13216560509554143,24522981,-1.0
2052,ARWR,1517896800000,5.71,5.73,5.14,5.36,1533470,0.2599999999999998,0.0,0.2599999999999998,46.06827515358141,5.14,6.75,35.403726708074544,-64.59627329192546,0.2792813932595841,0.3840553503796781,-0.06546644844517191,26056451,1.0
2053,ARWR,1517983200000,5.86,6.1136,5.67,5.69,1145797,0.15000000000000036,0.0,0.15000000000000036,51.65848264078259,5.14,6.75,44.72049689440997,-55.27950310559003,0.25758820057962684,0.35875666608850904,-0.06836248012718593,27202248,1.0
2054,ARWR,1518069600000,5.66,6.04,5.63,5.92,835087,-0.20000000000000018,0.20000000000000018,0.0,44.5536542705123,5.14,6.75,32.29813664596276,-67.70186335403724,0.22242707708580856,0.33148621720745514,-0.07516339869281041,26367161,-1.0
2055,ARWR,1518156000000,5.59,5.98,5.38,5.75,1244980,-0.07000000000000028,0.07000000000000028,0.0,42.20923451230794,5.14,6.59,31.034482758620697,-68.9655172413793,0.18700556134025437,0.3025862445687441,-0.09400324149108596,25122181,-1.0
2056,ARWR,1518415200000,5.31,5.65,5.3,5.42,1626986,-0.28000000000000025,0.28000000000000025,0.0,33.96131462936658,5.14,6.43,13.178294573643404,-86.8217054263566,0.13567389430996712,0.2692002243063647,-0.1351791530944626,23495195,-1.0
2057,ARWR,1518501600000,5.16,5.42,4.7704,5.2,2050504,-0.14999999999999947,0.14999999999999947,0.0,30.30132607651484,4.7704,6.38,24.204771371769375,-75.79522862823063,0.08240227800307487,0.231837456572947,-0.16504854368932032,21444691,-1.0
2058,ARWR,1518588000000,5.47,5.55,5.01,5.1,868219,0.3099999999999996,0.0,0.3099999999999996,44.55106178863961,4.7704,6.35,44.289693593314745,-55.71030640668526,0.06364443948889598,0.1981965636756047,-0.11056910569105705,22312910,1.0
2059,ARWR,1518674400000,5.83,5.9,5.41,5.51,1423524,0.3600000000000003,0.0,0.3600000000000003,56.474786011391615,4.7704,6.35,67.08027348695873,-32.91972651304126,0.07604787147113079,0.17376549508081426,-0.011864406779661052,23736434,1.0
2060,ARWR,1518760800000,5.57,5.95,5.46,5.85,1198951,-0.2599999999999998,0.2599999999999998,0.0,47.892467038644654,4.7704,6.35,50.620410230438104,-49.379589769561896,0.06474984514543625,0.15196141539212651,0.022018348623853212,22537483,-1.0
2061,ARWR,1519106400000,5.65,5.83,5.48,5.48,794469,0.08000000000000007,0.0,0.08000000000000007,50.55990250842324,4.7704,6.35,55.68498354013677,-44.31501645986323,0.06137178096006757,0.1338428571661048,-0.010507880910682998,23331952,1.0
2062,ARWR,1519192800000,5.54,5.81,5.53,5.65,741605,-0.11000000000000032,0.11000000000000032,0.0,46.76205435068029,4.7704,6.275,51.14980725774289,-48.85019274225711,0.04946746692706583,0.11696730869666387,-0.05460750853242324,22590347,-1.0
2063,ARWR,1519279200000,5.54,5.74,5.5,5.63,639730,0.0,0.0,0.0,46.76205435068029,4.7704,6.15,55.78428530008696,-44.21571469991304,0.039578650748526734,0.10148923193439041,-0.021201413427561877,22590347,0.0
2064,ARWR,1519365600000,5.8,5.808,5.35,5.61,955331,0.2599999999999998,0.0,0.2599999999999998,56.940412163085206,4.7704,6.1136,76.65276950565811,-23.347230494341886,0.05167918738068433,0.09152704529230046,0.0375670840787119,23545678,1.0
2065,ARWR,1519624800000,6.56,6.68,5.86,5.86,2535058,0.7599999999999998,0.0,0.7599999999999998,73.8212378167577,4.7704,6.68,93.71596145789694,-6.284038542103067,0.1199935973730133,0.09722043696724435,0.2354048964218456,26080736,1.0
2066,ARWR,1519711200000,6.45,6.8,6.33,6.62,2027777,-0.10999999999999943,0.10999999999999943,0.0,69.28505664149999,4.7704,6.8,82.75522270398109,-17.244777296018906,0.16351450893063735,0.11047940275054952,0.25,24052959,-1.0
2067,ARWR,1519797600000,6.48,6.64,6.38,6.53,1537546,0.03000000000000025,0.0,0.03000000000000025,69.86771977862738,4.7704,6.8,84.2333464722113,-15.766653527788701,0.19808684056730996,0.12800105036338083,0.1846435100548447,25590505,1.0
2068,ARWR,1519884000000,6.28,6.66,6.16,6.47,1592099,-0.20000000000000018,0.20000000000000018,0.0,60.9706803912187,4.7704,6.8,74.37918801734334,-25.620811982656665,0.20719984585617812,0.1438409252119554,0.07718696397941693,23998406,-1.0
2069,ARWR,1519970400000,6.66,6.665,6.12,6.13,1226923,0.3799999999999999,0.0,0.3799999999999999,69.48858542956637,4.7704,6.8,93.10208908159244,-6.897910918407554,0.2418435708384541,0.16344156892274667,0.19569120287253128,25225329,1.0
2070,ARWR,1520229600000,7.28,7.65,6.61,6.62,3762541,0.6200000000000001,0.0,0.6200000000000001,78.37394658147066,4.7704,7.65,87.15099319349909,-12.849006806500906,0.31501068343409067,0.1937555335975243,0.2884955752212388,28987870,1.0
2071,ARWR,1520316000000,7.46,7.8,7.37,7.39,2095513,0.17999999999999972,0.0,0.17999999999999972,80.2961226249922,5.01,7.8,87.8136200716846,-12.186379928315407,0.38290729025566517,0.23158602646983026,0.3465703971119134,31083383,1.0
2072,ARWR,1520402400000,7.39,7.6,7.18,7.45,1378834,-0.07000000000000028,0.07000000000000028,0.0,77.21648676176692,5.35,7.8,83.26530612244898,-16.734693877551024,0.42620226970458663,0.2705093916204603,0.3339350180505414,29704549,-1.0
2073,ARWR,1520488800000,7.34,7.51,7.2112,7.44,1141939,-0.04999999999999982,0.04999999999999982,0.0,74.85046271296267,5.35,7.8,81.22448979591837,-18.77551020408163,0.45130623363068434,0.30666884660719806,0.2655172413793103,28562610,-1.0
2074,ARWR,1520575200000,7.41,7.45,7.21,7.4,844208,0.07000000000000028,0.0,0.07000000000000028,76.03659619452168,5.35,7.8,84.08163265306123,-15.91836734693876,0.47134918477098786,0.3396049773330479,0.12957317073170738,29406818,1.0
2075,ARWR,1520830800000,7.54,7.93,7.3614,7.42,1997695,0.1299999999999999,0.0,0.1299999999999999,78.23614042745317,5.35,7.93,84.88372093023257,-15.11627906976743,0.4919460729900669,0.3700732431569332,0.1689922480620154,31404513,1.0
2076,ARWR,1520917200000,7.64,7.77,7.28,7.53,1857580,0.09999999999999964,0.0,0.09999999999999964,79.8756383188337,5.35,7.93,88.75968992248062,-11.24031007751938,0.5103768355358342,0.39813399603509636,0.17901234567901225,33262093,1.0
2077,ARWR,1521003600000,7.37,7.79,7.25,7.7,1425918,-0.2699999999999996,0.2699999999999996,0.0,64.69309448384821,5.35,7.93,78.29457364341087,-21.70542635658913,0.49762268200312043,0.41803175274436416,0.17356687898089174,31836175,-1.0
2078,ARWR,1521090000000,7.57,7.57,7.31,7.42,1302206,0.20000000000000018,0.0,0.20000000000000018,69.62740268462804,5.86,7.93,82.60869565217394,-17.391304347826065,0.49779176260807745,0.433983767233659,0.13663663663663672,33138381,1.0
2079,ARWR,1521176400000,7.53,7.58,7.27,7.45,5068300,-0.040000000000000036,0.040000000000000036,0.0,67.45200150132682,6.12,7.93,77.90055248618786,-22.09944751381213,0.4890758743698065,0.4450021955772681,0.03434065934065944,28070081,-1.0
2080,ARWR,1521435600000,7.17,7.55,7.04,7.53,1411543,-0.3600000000000003,0.3600000000000003,0.0,50.92825919896917,6.12,7.93,58.01104972375691,-41.988950276243095,0.44813010212010695,0.44562777719998303,-0.03887399463806973,26658538,-1.0
2081,ARWR,1521522000000,7.19,7.35,7.11,7.24,801961,0.020000000000000462,0.0,0.020000000000000462,51.68693041164656,6.12,7.93,59.11602209944754,-40.88397790055246,0.41252720255275044,0.43900765961100685,-0.027063599458727938,27460499,1.0
2082,ARWR,1521608400000,7.32,7.38,7.06,7.15,1001002,0.1299999999999999,0.0,0.1299999999999999,56.70691038339209,6.12,7.93,66.29834254143648,-33.70165745856351,0.3902448567047756,0.4292550958954075,-0.0027247956403269047,28461501,1.0
2083,ARWR,1521694800000,6.91,7.39,6.91,7.18,1059440,-0.41000000000000014,0.41000000000000014,0.0,41.14812176534111,6.61,7.93,22.727272727272723,-77.27272727272727,0.3357932001077293,0.4105627119318713,-0.06747638326585692,27402061,-1.0
2084,ARWR,1521781200000,6.75,7.0785,6.71,6.95,987027,-0.16000000000000014,0.16000000000000014,0.0,36.62348708102987,6.71,7.93,3.2786885245901676,-96.72131147540983,0.2765998379773542,0.3837701316300538,-0.10477453580901852,26415034,-1.0
2085,ARWR,1522040400000,6.94,7.025,6.52,6.83,1376151,0.1900000000000004,0.0,0.1900000000000004,44.92188236918745,6.52,7.93,29.787234042553244,-70.21276595744675,0.2421639041881054,0.35544888148138953,-0.09162303664921456,27791185,1.0
2086,ARWR,1522126800000,6.91,8.09,6.87,7.3,4395885,-0.03000000000000025,0.03000000000000025,0.0,43.87523403880997,6.52,8.09,24.84076433121022,-75.15923566878978,0.2100404178288331,0.3263671849225531,-0.062415196743555,23395300,-1.0
2087,ARWR,1522213200000,6.72,7.0652,6.56,6.92,1838131,-0.1900000000000004,0.1900000000000004,0.0,37.491737097055214,6.52,8.09,12.738853503184721,-87.26114649681527,0.16737718921112243,0.29456918243154645,-0.11228533685601061,21557169,-1.0
2088,ARWR,1522299600000,7.21,7.325,6.63,6.75,1564442,0.4900000000000002,0.0,0.4900000000000002,56.377670328235524,6.52,8.09,43.94904458598728,-56.050955414012726,0.1710010370567101,0.2698555512744598,-0.04249667994687922,23121611,1.0
2089,ARWR,1522645200000,6.86,7.27,6.67,7.19,1545582,-0.34999999999999964,0.34999999999999964,0.0,45.13780045699438,6.52,8.09,21.656050955414056,-78.34394904458594,0.14405741134472017,0.24469592159275616,-0.04323570432357038,21576029,-1.0
2090,ARWR,1522731600000,6.69,7.0,6.6,6.9,1218270,-0.16999999999999993,0.16999999999999993,0.0,40.601281944248775,6.52,8.09,10.828025477707056,-89.17197452229294,0.10778407784529787,0.21731355136681002,-0.06954102920723226,20357759,-1.0
2091,ARWR,1522818000000,7.11,7.135,6.311,6.6,1389801,0.41999999999999993,0.0,0.41999999999999993,53.82935329194396,6.311,8.09,44.91287240022487,-55.08712759977513,0.11155149971126121,0.19616114012327168,-0.02868852459016391,21747560,1.0
2092,ARWR,1522904400000,6.85,7.17,6.8,7.17,1186905,-0.2600000000000007,0.2600000000000007,0.0,46.44180237833267,6.311,8.09,30.29792017987632,-69.70207982012369,0.09254203371789327,0.1754373181270432,-0.00868306801736618,20560655,-1.0
2093,ARWR,1522990800000,6.37,6.9313,6.26,6.77,1487798,-0.47999999999999954,0.47999999999999954,0.0,35.936044393265476,6.26,8.09,6.010928961748651,-93.98907103825135,0.038391358810008214,0.14802812550695102,-0.05629629629629629,19072857,-1.0
2094,ARWR,1523250000000,6.38,6.61,6.37,6.43,1272080,0.009999999999999787,0.0,0.009999999999999787,36.28252866692638,6.26,8.09,6.557377049180333,-93.44262295081967,-0.003674825938023929,0.11768753454786622,-0.08069164265129691,20344937,1.0
2095,ARWR,1523336400000,6.76,6.8,6.43,6.49,1342153,0.3799999999999999,0.0,0.3799999999999999,48.49607097621224,6.26,8.09,27.322404371584696,-72.6775956284153,-0.006336201413763121,0.0928827869172784,-0.02170767004341534,21687090,1.0
2096,ARWR,1523422800000,7.23,7.3,6.86,7.01,1524308,0.47000000000000064,0.0,0.47000000000000064,59.55894073398663,6.26,8.09,53.00546448087435,-46.994535519125655,0.029075490431695883,0.08012132743978151,0.0758928571428572,23211398,1.0
2097,ARWR,1523509200000,7.25,7.415,7.08,7.3,983761,0.019999999999999574,0.0,0.019999999999999574,59.981000265447946,6.26,8.09,54.09836065573771,-45.901639344262286,0.05808039092417783,0.07571314008681378,0.00554785020804438,24195159,1.0
2098,ARWR,1523595600000,7.22,7.27,6.9872,7.27,746495,-0.03000000000000025,0.03000000000000025,0.0,58.9167852129106,6.26,8.09,52.45901639344262,-47.54098360655738,0.07775308614012744,0.07612112930116728,0.05247813411078717,23448664,-1.0
2099,ARWR,1523854800000,6.84,7.23,6.815,7.23,895612,-0.3799999999999999,0.3799999999999999,0.0,46.78482557502813,6.26,8.09,31.693989071038253,-68.30601092896174,0.06201006009086285,0.07329891543868203,0.022421524663676973,22553052,-1.0
2100,ARWR,1523941200000,6.85,6.97,6.77,6.85,860709,0.009999999999999787,0.0,0.009999999999999787,47.11548790928334,6.26,7.415,51.08225108225106,-48.917748917748945,0.04976582865671997,0.06859229805504016,-0.0365682137834038,23413761,1.0
2101,ARWR,1524027600000,7.01,7.0675,6.745,6.88,715595,0.16000000000000014,0.0,0.16000000000000014,52.5577831801068,6.26,7.415,64.93506493506493,-35.06493506493508,0.05235338073133722,0.06534451457525688,0.023357664233576658,24129356,1.0
2102,ARWR,1524114000000,6.95,7.0892,6.85,6.98,659602,-0.05999999999999961,0.05999999999999961,0.0,50.317258441289354,6.26,7.415,59.74025974025976,-40.25974025974024,0.049003076052442474,0.062076226858583855,0.09105180533751955,23469754,-1.0
2103,ARWR,1524200400000,6.97,7.029,6.8744,6.91,672716,0.019999999999999574,0.0,0.019999999999999574,51.11871860139947,6.26,7.415,61.47186147186146,-38.52813852813854,0.04741343908872864,0.0591436692959199,0.09247648902821304,24142470,1.0
2104,ARWR,1524459600000,6.85,7.04,6.735,7.0,940071,-0.1200000000000001,0.1200000000000001,0.0,45.983301823050724,6.26,7.415,51.08225108225106,-48.917748917748945,0.0360643784235295,0.054527811110495684,0.013313609467455523,23202399,-1.0
2105,ARWR,1524546000000,6.52,6.89,6.47,6.89,1012414,-0.33000000000000007,0.33000000000000007,0.0,34.8683470979183,6.26,7.415,22.510822510822486,-77.48917748917751,0.00046093234019295437,0.043714435335920676,-0.09820193637621033,22189985,-1.0
2106,ARWR,1524632400000,6.61,6.7,6.33,6.51,616567,0.09000000000000075,0.0,0.09000000000000075,39.47237212486361,6.26,7.415,30.303030303030344,-69.69696969696966,-0.020265024060468484,0.030918543437222393,-0.08827586206896543,22806552,1.0
2107,ARWR,1524718800000,6.74,6.76,6.55,6.6,516593,0.1299999999999999,0.0,0.1299999999999999,45.85175555979291,6.33,7.415,37.78801843317974,-62.21198156682026,-0.02590990807469229,0.019552853121039604,-0.06648199445983372,23323145,1.0
2108,ARWR,1524805200000,6.66,6.86,6.55,6.77,553475,-0.08000000000000007,0.08000000000000007,0.0,42.65924215285408,6.33,7.415,30.414746543778808,-69.58525345622118,-0.036414339963751985,0.008359414493208714,-0.02631578947368418,22769670,-1.0
2109,ARWR,1525064400000,6.42,6.7694,6.41,6.74,656439,-0.2400000000000002,0.2400000000000002,0.0,34.37444902516688,6.33,7.415,8.294930875576025,-91.70506912442397,-0.06336168334502901,-0.005984805085585255,-0.06277372262773717,22113231,-1.0
2110,ARWR,1525150800000,6.43,6.4879999999999995,6.3066,6.45,992286,0.009999999999999787,0.0,0.009999999999999787,34.98152351912026,6.3066,7.415,11.133164922410623,-88.86683507758939,-0.08295473401157771,-0.021378790880353476,-0.08273894436519258,23105517,1.0
2111,ARWR,1525237200000,7.14,7.23,6.31,6.41,2109651,0.71,0.0,0.71,63.01220738031956,6.3066,7.27,86.50612414365789,-13.493875856342122,-0.040754216826560885,-0.02525387607152213,0.027338129496402797,25215168,1.0
2112,ARWR,1525323600000,7.38,7.46,7.0063,7.13,1539824,0.2400000000000002,0.0,0.2400000000000002,68.33644445241717,6.3066,7.46,93.06398474076643,-6.936015259233579,0.011908228539649457,-0.01782145514633076,0.05882352941176472,26754992,1.0
2113,ARWR,1525410000000,7.17,7.4,7.09,7.36,999414,-0.20999999999999996,0.20999999999999996,0.0,59.665294103326964,6.3066,7.46,74.8569446852783,-25.143055314721707,0.036288109949900615,-0.006999542123640014,0.046715328467153316,25755578,-1.0
2114,ARWR,1525669200000,7.77,7.78,7.17,7.17,1116180,0.5999999999999996,0.0,0.5999999999999996,71.5615466143304,6.3066,7.78,99.32129767883802,-0.6787023211619843,0.10281689519461867,0.014963745345604223,0.19171779141104306,26871758,1.0
2115,ARWR,1525755600000,7.75,7.82,7.58,7.77,757527,-0.019999999999999574,0.019999999999999574,0.0,70.75887327125147,6.3066,7.82,95.3746530989824,-4.625346901017595,0.15217374907859238,0.04240574609779188,0.172465960665658,26114231,-1.0
2116,ARWR,1525842000000,9.0,9.6,8.11,8.42,5661435,1.25,0.0,1.25,83.83472759628629,6.3066,9.6,81.78174530879943,-18.218254691200578,0.2887852856203681,0.09168165401033726,0.33531157270029666,31775666,1.0
2117,ARWR,1525928400000,9.12,9.49,8.83,8.98,2812317,0.11999999999999922,0.0,0.11999999999999922,84.59765289554404,6.3066,9.6,85.42539624703952,-14.574603752960483,0.4020946009468336,0.15376424340573022,0.36936936936936915,34587983,1.0
2118,ARWR,1526014800000,9.88,9.89,8.92,9.15,2691003,0.7600000000000016,0.0,0.7600000000000016,88.5474949823204,6.3066,9.89,99.72093542445722,-0.27906457554277464,0.5468932541529652,0.23239004556337753,0.5389408099688475,37278986,1.0
2119,ARWR,1526274000000,9.42,10.1,8.87,9.98,3072800,-0.46000000000000085,0.46000000000000085,0.0,75.09780651430458,6.3066,10.1,82.07412874993409,-17.9258712500659,0.6174225471111363,0.3093965458793545,0.46500777604976684,34206186,-1.0
2120,ARWR,1526360400000,9.6,9.75,9.16,9.38,1285700,0.17999999999999972,0.0,0.17999999999999972,76.69599876432291,6.3066,10.1,86.81921231612802,-13.180787683871992,0.6799986980789638,0.3835169763242239,0.34453781512605053,35491886,1.0
2121,ARWR,1526446800000,9.51,9.62,9.35,9.56,1280236,-0.08999999999999986,0.08999999999999986,0.0,73.95762768029006,6.3066,10.1,84.44667053303105,-15.553329466968947,0.7140982411552512,0.4496332292939599,0.28861788617886175,34211650,-1.0
2122,ARWR,1526533200000,9.53,9.82,9.44,9.49,971514,0.019999999999999574,0.0,0.019999999999999574,74.19388087154731,6.3066,10.1,84.97390204038592,-15.026097959614077,0.734271172019838,0.5065608178415675,0.32914923291492326,35183164,1.0
2123,ARWR,1526619600000,10.0,10.38,9.52,9.66,2105066,0.47000000000000064,0.0,0.47000000000000064,79.2886199498755,6.3066,10.38,90.67118377767956,-9.32881622232044,0.7791923801961627,0.56108713031435,0.287001287001287,37288230,1.0
2124,ARWR,1526878800000,9.77,10.35,9.63,10.17,1333887,-0.23000000000000043,0.23000000000000043,0.0,71.33640100168016,6.31,10.38,85.01228501228498,-14.987714987715012,0.7871632678684257,0.6063023578264014,0.26064516129032245,35954343,-1.0
2125,ARWR,1526965200000,9.74,10.01,9.58,9.75,1198907,-0.02999999999999936,0.02999999999999936,0.0,70.27562541790911,7.0063,10.38,81.02972997006252,-18.97027002993747,0.782044747730982,0.6414508358080864,0.0822222222222222,34755436,-1.0
2126,ARWR,1527051600000,9.77,9.94,9.65,9.7,744585,0.02999999999999936,0.0,0.02999999999999936,70.77702577815926,7.09,10.38,81.45896656534951,-18.541033434650487,0.7715147960398063,0.6674636278548854,0.07127192982456143,35500021,1.0
2127,ARWR,1527138000000,9.77,9.83,9.56,9.79,741544,0.0,0.0,0.0,70.77702577815926,7.17,10.38,80.99688473520246,-19.00311526479754,0.7544724204314477,0.6848653863704415,-0.011133603238866474,35500021,0.0
2128,ARWR,1527224400000,10.05,10.18,9.78,9.81,1437711,0.28000000000000114,0.0,0.28000000000000114,75.84092263033406,7.58,10.38,88.21428571428571,-11.785714285714285,0.7548546803147609,0.6988632451594621,0.06687898089171984,36937732,1.0
2129,ARWR,1527570000000,10.3,10.33,9.96,10.0,1198296,0.25,0.0,0.25,79.50051898359652,8.11,10.38,96.47577092511013,-3.524229074889869,0.7664917907143423,0.7123889542705594,0.07291666666666674,38136028,1.0
2130,ARWR,1527656400000,10.89,11.0,10.4,10.4,2797082,0.5899999999999999,0.0,0.5899999999999999,85.4869837692599,8.83,11.0,94.93087557603688,-5.069124423963108,0.8139332940264623,0.7326978222218855,0.1451104100946372,40933110,1.0
2131,ARWR,1527742800000,10.72,11.57,10.5302,11.0,3022342,-0.16999999999999993,0.16999999999999993,0.0,77.92161142245052,8.87,11.57,68.51851851851855,-31.481481481481456,0.8282671414350098,0.75181168606462,0.12486883525708303,37910768,-1.0
2132,ARWR,1527829200000,10.91,11.0,10.6201,10.76,1196291,0.1899999999999995,0.0,0.1899999999999995,80.18321320007044,8.87,11.57,75.55555555555557,-24.44444444444444,0.8452131956493645,0.7704919879816545,0.09099999999999997,39107059,1.0
2133,ARWR,1528088400000,10.79,11.14,10.23,10.99,1551918,-0.120000000000001,0.120000000000001,0.0,74.61339383666902,9.16,11.57,67.63485477178419,-32.365145228215816,0.8392861371444962,0.7842508178142734,0.10440122824974418,37555141,-1.0
2134,ARWR,1528174800000,10.61,10.95,10.47,10.76,1601233,-0.17999999999999972,0.17999999999999972,0.0,66.60568753322619,9.35,11.57,56.75675675675673,-43.24324324324327,0.810720199614158,0.7895446941742659,0.08932238193018471,35953908,-1.0
2135,ARWR,1528261200000,10.69,10.7,10.49,10.58,1184524,0.08000000000000007,0.0,0.08000000000000007,68.34774085134373,9.44,11.57,58.68544600938965,-41.31455399061035,0.7854815811465095,0.7887320715687126,0.09416581371545552,37138432,1.0
2136,ARWR,1528347600000,10.37,10.775,9.67,10.75,1718534,-0.3200000000000003,0.3200000000000003,0.0,55.08507618373535,9.52,11.57,41.46341463414631,-58.53658536585369,0.7312313522246363,0.7772319276998758,0.06141248720573178,35419898,-1.0
2137,ARWR,1528434000000,10.31,10.4,10.12,10.32,1149385,-0.05999999999999872,0.05999999999999872,0.0,52.86570554367246,9.56,11.57,37.3134328358209,-62.686567164179095,0.6756084752549754,0.7569072372108651,0.025870646766169125,34270513,-1.0
2138,ARWR,1528693200000,11.11,11.53,10.115,10.27,2185980,0.7999999999999989,0.0,0.7999999999999989,70.90195764782769,9.56,11.57,77.11442786069648,-22.885572139303527,0.6881430824012398,0.7431544062489235,0.07864077669902891,36456493,1.0
2139,ARWR,1528779600000,11.35,11.48,11.09,11.17,1223365,0.2400000000000002,0.0,0.2400000000000002,74.30541321933912,9.56,11.57,89.05472636815918,-10.945273631840829,0.7092654881418436,0.736376622627501,0.04224058769513306,37679858,1.0
2140,ARWR,1528866000000,11.66,11.8375,11.1565,11.39,1288719,0.3100000000000005,0.0,0.3100000000000005,78.11965963231346,9.56,11.8375,92.20636663007683,-7.793633369923171,0.7424593098379138,0.7375931600695845,0.08768656716417911,38968577,1.0
2141,ARWR,1528952400000,11.65,11.78,11.15,11.67,1380855,-0.009999999999999787,0.009999999999999787,0.0,77.69039938085196,9.67,11.8375,91.34948096885813,-8.650519031141867,0.7592070171961591,0.741915931494902,0.06782768102658121,37587722,-1.0
2142,ARWR,1529038800000,11.07,11.64,11.07,11.6,1970705,-0.5800000000000001,0.5800000000000001,0.0,56.80218642717967,9.67,11.8375,64.59054209919263,-35.409457900807375,0.7174110637521096,0.7370149579463411,0.02594995366079722,35617017,-1.0
2143,ARWR,1529298000000,13.73,14.0,11.43,11.68,5610604,2.66,0.0,2.66,82.17009132655733,9.67,14.0,93.76443418013858,-6.235565819861422,0.888672626645171,0.767346491686119,0.29406220546654116,41227621,1.0
2144,ARWR,1529384400000,14.02,14.24,12.8,13.45,3128032,0.28999999999999915,0.0,0.28999999999999915,83.39663553041818,9.67,14.24,95.18599562363237,-4.814004376367628,1.0358572913423743,0.8210486516173869,0.31150608044901773,44355653,1.0
2145,ARWR,1529470800000,13.13,14.16,12.9701,14.1,2140896,-0.8899999999999988,0.8899999999999988,0.0,67.06075828739901,9.67,14.24,75.71115973741796,-24.288840262582042,1.068373953884862,0.8705137120708945,0.26615236258437824,42214757,-1.0
2146,ARWR,1529557200000,13.18,13.47,12.99,13.2,1436905,0.049999999999998934,0.0,0.049999999999998934,67.47376361069146,9.67,14.24,76.80525164113786,-23.194748358862157,1.0856631288444234,0.9135435954256088,0.27837051406401536,43651662,1.0
2147,ARWR,1529643600000,13.26,13.53,12.99,13.37,12861592,0.08000000000000007,0.0,0.08000000000000007,68.20964085928257,9.67,14.24,78.5557986870897,-21.444201312910295,1.0932180073100408,0.9494784778025009,0.19351935193519365,56513254,1.0
2148,ARWR,1529902800000,13.47,13.95,12.98,13.0,2073026,0.21000000000000085,0.0,0.21000000000000085,70.24837004473582,9.67,14.24,83.15098468271336,-16.849015317286643,1.1034302554332882,0.9802688333286624,0.18678414096916307,58586280,1.0
2149,ARWR,1529989200000,13.32,13.54,13.15,13.41,1729186,-0.15000000000000036,0.15000000000000036,0.0,66.72180604070456,9.67,14.24,79.86870897155362,-20.131291028446388,1.0868910913316991,1.001593284929272,0.1423670668953687,56857094,-1.0
2150,ARWR,1530075600000,13.22,13.837,13.2,13.4,1768558,-0.09999999999999964,0.09999999999999964,0.0,64.2410459338549,10.115,14.24,75.27272727272728,-24.727272727272716,1.0535698004640643,1.0119885880362312,0.134763948497854,55088536,-1.0
2151,ARWR,1530162000000,12.95,13.25,12.61,13.22,1823351,-0.27000000000000135,0.27000000000000135,0.0,57.57232676952737,10.115,14.24,68.7272727272727,-31.272727272727295,0.9939189476443708,1.008374659957859,0.16982836495031606,53265185,-1.0
2152,ARWR,1530248400000,13.6,13.79,12.8852,13.14,2284555,0.6500000000000004,0.0,0.6500000000000004,67.06833383092305,11.07,14.24,79.81072555205046,-20.189274447949547,0.9877077897059934,1.0042412859074854,-0.009468317552804084,55549740,1.0
2153,ARWR,1530507600000,14.87,14.93,13.33,13.71,2713418,1.2699999999999996,0.0,1.2699999999999996,78.11238695059009,11.07,14.93,98.44559585492226,-1.5544041450777333,1.0728937736597715,1.017971783457943,0.060627674750356686,58263158,1.0
2154,ARWR,1530594000000,15.02,15.75,14.66,14.84,1492191,0.15000000000000036,0.0,0.15000000000000036,79.0690082238983,11.07,15.75,84.4017094017094,-15.59829059829061,1.1393737202585754,1.04225217081807,0.14394516374714383,59755349,1.0
2155,ARWR,1530766800000,15.3,15.31,14.74,15.1,1704565,0.28000000000000114,0.0,0.28000000000000114,80.8698467017786,11.07,15.75,90.3846153846154,-9.6153846153846,1.200810526586766,1.07396384197181,0.16084977238239762,61459914,1.0
2156,ARWR,1530853200000,15.83,15.88,15.15,15.28,1845954,0.5299999999999994,0.0,0.5299999999999994,83.89596208819552,11.43,15.88,98.87640449438202,-1.1235955056179934,1.277538716277821,1.114678816833013,0.19381598793363497,63305868,1.0
2157,ARWR,1531112400000,16.4,16.4,15.58,16.0,1889788,0.5699999999999985,0.0,0.5699999999999985,86.53842958264839,12.61,16.4,100.0,-0.0,1.3685638244177696,1.1654558183499653,0.2175204157386783,65195656,1.0
2158,ARWR,1531198800000,16.11,16.5,15.84,16.32,1555644,-0.28999999999999915,0.28999999999999915,0.0,78.93490412822537,12.61,16.5,89.97429305912596,-10.025706940874048,1.4011500235230212,1.2125946593845771,0.20945945945945943,63640012,-1.0
2159,ARWR,1531285200000,16.42,16.5,15.6304,16.0,1417375,0.3100000000000023,0.0,0.3100000000000023,80.99456368534945,12.61,16.5,97.94344473007716,-2.056555269922835,1.4354419493562567,1.2571641173789134,0.24205748865355536,65057387,1.0
2160,ARWR,1531371600000,16.41,16.64,16.06,16.45,1663085,-0.010000000000001563,0.010000000000001563,0.0,80.70086877231765,12.61,16.64,94.29280397022332,-5.707196029776684,1.4451527798448272,1.2947618498720965,0.2671814671814672,63394302,-1.0
2161,ARWR,1531458000000,16.41,16.48,16.0,16.41,838870,0.0,0.0,0.0,80.70086877231765,12.61,16.64,94.29280397022332,-5.707196029776684,1.4362919687243423,1.3230678736425459,0.20661764705882346,63394302,0.0
2162,ARWR,1531717200000,15.8,16.7603,15.53,16.2,1516010,-0.6099999999999994,0.6099999999999994,0.0,62.34196682482451,12.61,16.7603,76.86191359660748,-23.13808640339252,1.3643212919576282,1.3313185573055624,0.06254203093476818,61878292,-1.0
2163,ARWR,1531803600000,16.45,16.47,15.62,15.72,1085900,0.6499999999999986,0.0,0.6499999999999986,70.57287497040161,12.61,16.7603,92.52343204105725,-7.476567958942762,1.3442374772226398,1.3339023412889779,0.09520639147802923,62964192,1.0
2164,ARWR,1531890000000,16.67,17.18,16.32,16.49,2256051,0.22000000000000242,0.0,0.22000000000000242,72.88718708971088,12.61,17.18,88.84026258205694,-11.159737417943063,1.3307330138034246,1.3332684757918674,0.08954248366013084,65220243,1.0
2165,ARWR,1531976400000,16.31,16.6495,16.15,16.6,1475010,-0.360000000000003,0.360000000000003,0.0,63.46340582696747,12.8852,17.18,79.7429449566918,-20.25705504330821,1.276269833892151,1.321868747411924,0.030322173089071258,63745233,-1.0
2166,ARWR,1532062800000,16.03,16.56,15.78,16.29,1409856,-0.2799999999999976,0.2799999999999976,0.0,56.865225097750276,13.33,17.18,70.12987012987017,-29.870129870129837,1.1967188544475835,1.2968387688190557,-0.022560975609755896,62335377,-1.0
2167,ARWR,1532322000000,16.51,16.87,15.6591,16.08,1490511,0.4800000000000004,0.0,0.4800000000000004,64.22285060437613,14.66,17.18,73.41269841269849,-26.58730158730152,1.159045058742235,1.2692800268036917,0.024829298572315528,63825888,1.0
2168,ARWR,1532408400000,16.6,17.5,16.18,16.74,2142050,0.08999999999999986,0.0,0.08999999999999986,65.49613966825459,14.74,17.5,67.39130434782614,-32.608695652173864,1.1234994846843822,1.2401239183798298,0.010962241169305775,65967938,1.0
2169,ARWR,1532494800000,16.89,17.3,16.61,16.64,1449236,0.28999999999999915,0.0,0.28999999999999915,69.52816521152201,15.15,17.5,74.04255319148938,-25.95744680851062,1.1059807139538673,1.2132952774946373,0.029250457038391353,67417174,1.0
2170,ARWR,1532581200000,17.44,17.5,16.5,16.89,1673704,0.5500000000000007,0.0,0.5500000000000007,75.73361504222353,15.53,17.5,96.95431472081225,-3.0456852791877513,1.1235257761420936,1.1953413772241286,0.06276660572821458,69090878,1.0
2171,ARWR,1532667600000,16.07,17.5,16.01,17.5,1502701,-1.370000000000001,1.370000000000001,0.0,47.77234035357106,15.53,17.5,27.411167512690394,-72.5888324873096,1.0151810526355973,1.1593093123064222,0.017088607594936578,67588177,-1.0
2172,ARWR,1532926800000,14.0,16.215,12.25,15.96,7041152,-2.0700000000000003,2.0700000000000003,0.0,29.064364657365132,12.25,17.5,33.33333333333333,-66.66666666666666,0.7535992286151156,1.078167295568161,-0.14893617021276595,60547025,-1.0
2173,ARWR,1533013200000,14.57,15.3,14.1,14.2,2390635,0.5700000000000003,0.0,0.5700000000000003,36.913778271845025,12.25,17.5,44.1904761904762,-55.80952380952381,0.5855380492610447,0.9796414463067377,-0.12597480503899228,62937660,1.0
2174,ARWR,1533099600000,15.14,15.16,14.56,14.57,1341322,0.5700000000000003,0.0,0.5700000000000003,44.05659568947743,12.25,17.5,55.04761904761906,-44.95238095238094,0.49266327039500624,0.8822458111243914,-0.07173513182096858,64278982,1.0
2175,ARWR,1533186000000,15.32,15.38,14.71,14.98,865745,0.17999999999999972,0.0,0.17999999999999972,46.27311857540947,12.25,17.5,58.47619047619048,-41.52380952380952,0.4286426486532484,0.7915251786301628,-0.044291952588895844,65144727,1.0
2176,ARWR,1533272400000,14.54,15.4,14.3,15.27,1005462,-0.7800000000000011,0.7800000000000011,0.0,38.62195353132241,12.25,17.5,43.6190476190476,-56.3809523809524,0.31137724277588497,0.6954955914593073,-0.11932162325863127,64139265,-1.0
2177,ARWR,1533531600000,14.24,14.49,13.76,14.43,1288111,-0.29999999999999893,0.29999999999999893,0.0,35.98164672897916,12.25,17.5,37.904761904761905,-62.095238095238095,0.19202264224276888,0.5948010016159997,-0.14216867469879524,62851154,-1.0
2178,ARWR,1533618000000,15.1,15.28,14.05,14.29,2156175,0.8599999999999994,0.0,0.8599999999999994,47.78799592369203,12.25,17.5,54.285714285714285,-45.714285714285715,0.16492667528415694,0.5088261363496311,-0.10597986974541151,65007329,1.0
2179,ARWR,1533704400000,16.12,16.2,15.21,15.44,1846532,1.0200000000000014,0.0,1.0200000000000014,58.309887451897126,12.25,17.5,73.71428571428574,-26.285714285714267,0.22318540701986578,0.45169799048367804,-0.07568807339449546,66853861,1.0
2180,ARWR,1533790800000,16.51,16.95,15.75,16.04,1234460,0.39000000000000057,0.0,0.39000000000000057,61.71379761667793,12.25,17.5,81.14285714285717,-18.85714285714283,0.2973973090440065,0.42083785419574377,0.027380211574362212,68088321,1.0
2181,ARWR,1533877200000,16.89,17.0,16.27,16.34,1057234,0.379999999999999,0.0,0.379999999999999,64.93274372494781,12.25,17.5,88.3809523809524,-11.619047619047608,0.38246470123571186,0.4131632236037374,0.2064285714285714,69145555,1.0
2182,ARWR,1534136400000,16.3,17.187,16.02,16.96,1355464,-0.5899999999999999,0.5899999999999999,0.0,56.43274411582294,12.25,17.5,77.14285714285715,-22.857142857142843,0.3976889544639164,0.4100683697757732,0.11873713109128348,67790091,-1.0
2183,ARWR,1534222800000,16.35,16.99,16.24,16.27,1409229,0.05000000000000071,0.0,0.05000000000000071,56.98337101612971,12.25,17.5,78.09523809523812,-21.904761904761877,0.4090733133226152,0.40986935848514167,0.07992073976221925,69199320,1.0
2184,ARWR,1534309200000,14.75,16.6285,14.74,16.36,2063688,-1.6000000000000014,1.6000000000000014,0.0,38.852630822865066,12.25,17.5,47.61904761904761,-52.38095238095239,0.28569581537306377,0.3850346498627261,-0.03720626631853785,67135632,-1.0
2185,ARWR,1534395600000,14.33,15.21,13.95,14.85,1928179,-0.41999999999999993,0.41999999999999993,0.0,35.43749753984606,12.25,17.187,42.130848693538574,-57.86915130646142,0.15227253333762292,0.3384822265577055,-0.014442916093534985,65207453,-1.0
2186,ARWR,1534482000000,14.51,14.5724,13.981,14.44,1790784,0.17999999999999972,0.0,0.17999999999999972,38.126926264659225,13.76,17.187,21.885030639042885,-78.1149693609571,0.06036227400407057,0.2828582360469785,0.018960674157303403,66998237,1.0
2187,ARWR,1534741200000,14.17,14.78,13.85,14.63,1190666,-0.33999999999999986,0.33999999999999986,0.0,34.95352505351741,13.76,17.187,11.963816749343447,-88.03618325065655,-0.03945753845077249,0.2183950811474283,-0.06158940397350987,65807571,-1.0
2188,ARWR,1534827600000,14.1,14.23,13.8,14.11,1298885,-0.07000000000000028,0.07000000000000028,0.0,34.275808756306674,13.76,17.187,9.921213889699438,-90.07878611030056,-0.12279832101044263,0.15015640071585412,-0.1253101736972706,64508686,-1.0
2189,ARWR,1534914000000,14.39,14.44,14.04,14.11,1509018,0.2900000000000009,0.0,0.2900000000000009,39.85068814933235,13.76,17.187,18.383425736796045,-81.61657426320396,-0.16356052302393387,0.08741301596789651,-0.12840702604482135,66017704,1.0
2190,ARWR,1535000400000,14.39,14.5,14.05,14.44,1221686,0.0,0.0,0.0,39.85068814933235,13.76,17.187,18.383425736796045,-81.61657426320396,-0.19363278265132067,0.031203856244053065,-0.14801657785671996,66017704,0.0
2191,ARWR,1535086800000,14.69,14.78,14.42,14.42,923680,0.29999999999999893,0.0,0.29999999999999893,46.1424968733869,13.8,17.187,26.27694124594032,-73.72305875405968,-0.19105543280355697,-0.013248001565468955,-0.09877300613496942,66941384,1.0
2192,ARWR,1535346000000,14.74,15.04,14.55,14.93,1092822,0.05000000000000071,0.0,0.05000000000000071,47.20453024367493,13.8,17.187,27.753173900206658,-72.24682609979335,-0.18287027185781035,-0.04717245562393725,-0.09847094801223244,68034206,1.0
2193,ARWR,1535432400000,14.73,15.1,14.67,14.79,1007466,-0.009999999999999787,0.009999999999999787,0.0,46.99069380769724,13.8,17.187,27.457927369353396,-72.5420726306466,-0.17517112446911653,-0.07277218939297313,-0.0013559322033898091,67026740,-1.0
2194,ARWR,1535518800000,14.68,14.83,14.54,14.72,752182,-0.05000000000000071,0.05000000000000071,0.0,45.793888623041454,13.8,17.187,25.981694715087066,-74.01830528491293,-0.1711313767032525,-0.09244402685502902,0.02442428471737612,66274558,-1.0
2195,ARWR,1535605200000,14.4,14.8046,14.19,14.59,1061004,-0.27999999999999936,0.27999999999999936,0.0,39.32261287357346,13.8,17.187,17.714791851195734,-82.28520814880427,-0.18835227914903996,-0.11162567731383123,-0.007580978635423841,65213554,-1.0
2196,ARWR,1535691600000,14.76,14.81,14.29,14.31,1458632,0.35999999999999943,0.0,0.35999999999999943,49.83848714288242,13.8,16.99,30.094043887147325,-69.90595611285268,-0.17098004909480125,-0.12349655167002524,0.04163726182074812,66672186,1.0
2197,ARWR,1536037200000,15.31,15.44,14.23,14.6,1494431,0.5500000000000007,0.0,0.5500000000000007,61.57709938202713,13.8,16.6285,53.38518649460847,-46.614813505391524,-0.11154622661607405,-0.12110648665923503,0.0858156028368795,68166617,1.0
2198,ARWR,1536123600000,14.1,15.3,13.82,15.3,3142865,-1.2100000000000009,1.2100000000000009,0.0,38.62954820660149,13.8,15.44,18.29268292682922,-81.70731707317078,-0.16023423218948274,-0.12893203576528459,-0.020152883947185618,65023752,-1.0
2199,ARWR,1536210000000,19.39,22.39,18.0,18.0,28650132,5.290000000000001,0.0,5.290000000000001,78.69009400644313,13.8,22.39,65.07566938300349,-34.92433061699651,0.22543995072277312,-0.05805763846767302,0.3474635163307853,93673884,1.0
2200,ARWR,1536296400000,19.74,20.5,18.901,19.41,4744664,0.34999999999999787,0.0,0.34999999999999787,79.70162477362132,13.8,22.39,69.15017462165306,-30.84982537834694,0.5529574253686,0.06414537429958163,0.3437712729748128,98418548,1.0
2201,ARWR,1536555600000,20.3,20.37,19.32,19.89,1810788,0.5600000000000023,0.0,0.5600000000000023,81.33710211757989,13.8,22.39,75.66938300349243,-24.330616996507565,0.8479302633251997,0.22090235210470532,0.3772048846675713,100229336,1.0
2202,ARWR,1536642000000,19.82,21.18,19.8,20.1,2178361,-0.4800000000000004,0.4800000000000004,0.0,75.33400422999338,13.82,22.39,70.01166861143524,-29.988331388564767,1.0310807350001987,0.38293802868380405,0.3455532926001357,98050975,-1.0
2203,ARWR,1536728400000,19.13,20.0,18.94,19.86,1252713,-0.6900000000000013,0.6900000000000013,0.0,67.11764869608174,13.82,22.39,61.960326721120175,-38.03967327887983,1.1077817762081885,0.527906778188681,0.3031335149863761,96798262,-1.0
2204,ARWR,1536814800000,18.33,19.57,18.2,19.22,1837955,-0.8000000000000007,0.8000000000000007,0.0,58.57162233901492,13.82,22.39,52.6254375729288,-47.374562427071204,1.0914332542804637,0.6406120734070376,0.2729166666666665,94960307,-1.0
2205,ARWR,1536901200000,18.91,19.105,18.35,18.84,1512010,0.5800000000000018,0.0,0.5800000000000018,62.55960971467879,13.82,22.39,59.39323220536755,-40.60676779463244,1.1124543837792444,0.7349805354814791,0.28116531165311653,96472317,1.0
2206,ARWR,1537160400000,18.21,18.99,17.86,18.98,1311066,-0.6999999999999993,0.6999999999999993,0.0,55.164667175992406,13.82,22.39,51.22520420070013,-48.77479579929988,1.0604059515521982,0.8000656186956231,0.18941868060091438,95161251,-1.0
2207,ARWR,1537246800000,18.84,18.95,18.05,18.16,962269,0.629999999999999,0.0,0.629999999999999,60.06660122869192,13.82,22.39,58.57642940490081,-41.42357059509919,1.0577992589212393,0.8516123467407464,0.3361702127659574,96123520,1.0
2208,ARWR,1537333200000,18.58,18.98,18.13,18.8,1221929,-0.26000000000000156,0.26000000000000156,0.0,57.09411977675558,13.82,22.39,55.5425904317386,-44.457409568261404,1.0229615514031778,0.8858821876732328,-0.04177411036616829,94901591,-1.0
2209,ARWR,1537419600000,18.88,18.88,18.53,18.58,913420,0.3000000000000007,0.0,0.3000000000000007,59.746212234918005,13.82,22.39,59.04317386231037,-40.95682613768963,1.007940985887128,0.910293947316012,-0.0435663627152989,95815011,1.0
2210,ARWR,1537506000000,17.77,18.9114,17.68,18.88,3070848,-1.1099999999999994,1.1099999999999994,0.0,47.27171993539439,13.82,22.39,46.091015169194854,-53.90898483080514,0.8961392455241004,0.9074630069576297,-0.12463054187192124,92744163,-1.0
2211,ARWR,1537765200000,18.7,18.79,17.43,17.77,1322211,0.9299999999999997,0.0,0.9299999999999997,56.127261436335004,13.82,22.39,56.942823803967315,-43.057176196032685,0.8725208910280315,0.9004745837717102,-0.056508577194752774,94066374,1.0
2212,ARWR,1537851600000,19.37,19.45,18.5301,18.7,1249730,0.6700000000000017,0.0,0.6700000000000017,61.50191423191572,17.43,22.39,39.11290322580647,-60.88709677419353,0.8975205044111156,0.8998837678995913,0.01254573967590189,95316104,1.0
2213,ARWR,1537938000000,19.11,19.54,19.04,19.37,741202,-0.26000000000000156,0.26000000000000156,0.0,58.303765018652946,17.43,21.18,44.79999999999999,-55.2,0.8861382056676526,0.8971346554532036,0.042553191489361764,94574902,-1.0
2214,ARWR,1538024400000,19.0,19.4427,18.78,19.03,732130,-0.10999999999999943,0.10999999999999943,0.0,56.86036412598625,17.43,21.18,41.866666666666674,-58.133333333333326,0.8583470818780938,0.8893771407381816,0.004759386567953383,93842772,-1.0
2215,ARWR,1538110800000,19.17,19.43,19.0,19.0,1217881,0.1700000000000017,0.0,0.1700000000000017,58.68430024877454,17.43,21.18,46.400000000000055,-53.599999999999945,0.8403529269738996,0.8795722979853252,0.05271828665568368,95060653,1.0
2216,ARWR,1538370000000,19.21,19.46,18.82,19.17,1270631,0.03999999999999915,0.0,0.03999999999999915,59.153168151992574,17.43,20.0,69.2607003891051,-30.739299610894903,0.8198691532090017,0.8676316690300605,0.01963906581740993,96331284,1.0
2217,ARWR,1538456400000,19.7,19.74,18.76,19.42,2293227,0.48999999999999844,0.0,0.48999999999999844,64.7995203895922,17.43,19.74,98.2683982683983,-1.7316017316016956,0.8335656867381083,0.86081847257167,0.060279870828848336,98624511,1.0
2218,ARWR,1538542800000,18.56,19.94,17.84,19.7,2057684,-1.1400000000000006,1.1400000000000006,0.0,47.261700324878156,17.43,19.94,45.019920318725035,-54.980079681274965,0.7438571076660168,0.8374261995905393,-0.016949152542372947,96566827,-1.0
2219,ARWR,1538629200000,15.33,20.31,14.75,19.85,19095152,-3.2299999999999986,3.2299999999999986,0.0,25.075064494252402,14.75,20.31,10.431654676258995,-89.568345323741,0.4074318229307359,0.7514273242585786,-0.13731007315700616,77471675,-1.0
2220,ARWR,1538715600000,14.74,15.88,14.22,15.69,6034142,-0.5899999999999999,0.5899999999999999,0.0,22.817464986617765,14.22,20.31,8.538587848932671,-91.46141215106732,0.09214214112595087,0.6195702876320531,-0.21176470588235285,71437533,-1.0
2221,ARWR,1538974800000,13.75,14.87,12.8503,14.71,5624807,-0.9900000000000002,0.9900000000000002,0.0,19.430438888116797,12.8503,20.31,12.060806734855282,-87.93919326514472,-0.23490409129346546,0.44867541184694937,-0.29013939081053175,65812726,-1.0
2222,ARWR,1539061200000,13.76,14.3221,13.15,13.5,2835323,0.009999999999999787,0.0,0.009999999999999787,19.569589188888642,12.8503,20.31,12.194860383125318,-87.80513961687468,-0.48766220363814483,0.2614078887499305,-0.27995813710099426,68648049,1.0
2223,ARWR,1539147600000,12.64,13.79,12.5174,13.61,4333892,-1.1199999999999992,1.1199999999999992,0.0,15.99878468071924,12.5174,20.31,1.5732874778636181,-98.42671252213638,-0.7694793794272918,0.05523043511448595,-0.3347368421052631,64314157,-1.0
2224,ARWR,1539234000000,12.88,13.44,12.31,12.45,3261876,0.2400000000000002,0.0,0.2400000000000002,19.624943188515033,12.31,20.31,7.125000000000005,-92.875,-0.9623620185274451,-0.14828805561390032,-0.32811684924360984,67576033,1.0
2225,ARWR,1539320400000,13.11,13.94,12.51,13.15,2409873,0.22999999999999865,0.0,0.22999999999999865,23.286755390984467,12.31,20.31,9.99999999999999,-90.00000000000001,-1.0841662297341177,-0.33546369043794383,-0.3175429463820927,69985906,1.0
2226,ARWR,1539579600000,13.15,13.36,12.7526,12.91,1885043,0.040000000000000924,0.0,0.040000000000000924,23.981736153791402,12.31,20.31,10.500000000000002,-89.5,-1.1640508256341366,-0.5011811174771825,-0.33248730964467,71870949,1.0
2227,ARWR,1539666000000,13.87,14.0,13.0,13.04,2317662,0.7199999999999989,0.0,0.7199999999999989,36.020075158731565,12.31,20.31,19.49999999999999,-80.50000000000001,-1.1559370422339743,-0.6321323024285409,-0.2526939655172413,74188611,1.0
2228,ARWR,1539752400000,13.49,14.23,13.3,13.53,2067216,-0.379999999999999,0.379999999999999,0.0,32.851907071723716,12.31,20.31,14.75,-85.25,-1.1667204057499792,-0.7390499230928287,-0.12002609262883235,72121395,-1.0
2229,ARWR,1539838800000,13.35,13.6,12.960999999999999,13.51,1525963,-0.14000000000000057,0.14000000000000057,0.0,31.66784503452763,12.31,20.31,12.999999999999993,-87.00000000000001,-1.1730410411788874,-0.8258481467100406,-0.09430122116689288,70595432,-1.0
2230,ARWR,1539925200000,13.05,13.7,12.81,13.53,2191079,-0.29999999999999893,0.29999999999999893,0.0,29.07665403538978,12.31,20.31,9.250000000000004,-90.75,-1.1885567392484884,-0.8983898652177302,-0.050909090909090904,68404353,-1.0
2231,ARWR,1540184400000,12.98,13.1599,12.25,13.08,1438047,-0.07000000000000028,0.07000000000000028,0.0,28.449915231936927,12.25,20.31,9.057071960297773,-90.94292803970222,-1.19275215194312,-0.9572623225628082,-0.0566860465116279,66966306,-1.0
2232,ARWR,1540270800000,12.96,13.29,12.29,12.55,1447783,-0.019999999999999574,0.019999999999999574,0.0,28.249178045239177,12.25,20.31,8.808933002481401,-91.1910669975186,-1.184041980470404,-1.0026182541443274,0.025316455696202445,65518523,-1.0
2233,ARWR,1540357200000,11.98,12.9972,11.98,12.91,2195747,-0.9800000000000004,0.9800000000000004,0.0,20.193495474995558,11.98,15.88,0.0,-100.0,-1.2419010504698864,-1.0504748134094393,-0.06987577639751552,63322776,-1.0
2234,ARWR,1540443600000,12.57,12.84,12.0,12.01,1806005,0.5899999999999999,0.0,0.5899999999999999,33.38875464901538,11.98,14.87,20.415224913494814,-79.58477508650519,-1.2260139870433324,-1.0855826481362179,-0.041189931350114395,65128781,1.0
2235,ARWR,1540530000000,12.66,12.89,12.04,12.33,1319565,0.08999999999999986,0.0,0.08999999999999986,35.272435429364634,11.98,14.3221,29.03377310960248,-70.96622689039752,-1.1924157012390495,-1.1069492587567842,-0.03726235741444872,66448346,1.0
2236,ARWR,1540789200000,12.25,12.99,11.8893,12.81,2400423,-0.41000000000000014,0.41000000000000014,0.0,30.707876733993416,11.8893,14.23,15.409920109368974,-84.59007989063103,-1.1852100264133494,-1.1226014122880972,-0.11679884643114635,64047923,-1.0
2237,ARWR,1540875600000,12.46,12.5678,12.05,12.1,1459896,0.21000000000000085,0.0,0.21000000000000085,35.63081831027149,11.8893,14.23,24.38159524928442,-75.61840475071558,-1.14930575148016,-1.1279422801265098,-0.07635285396590064,65507819,1.0
2238,ARWR,1540962000000,12.72,13.11,12.51,12.73,1613776,0.2599999999999998,0.0,0.2599999999999998,41.56196142251332,11.8893,14.23,35.48938351775111,-64.51061648224889,-1.0873373799846906,-1.119821300098146,-0.04719101123595504,67121595,1.0
2239,ARWR,1541048400000,14.22,14.23,12.72,12.76,2676860,1.5,0.0,1.5,63.77901585776833,11.8893,14.23,99.57277737428976,-0.4272226257102485,-0.9067372363239059,-1.077204487343298,0.08965517241379306,69798455,1.0
2240,ARWR,1541134800000,14.49,14.66,14.02,14.36,1460780,0.2699999999999996,0.0,0.2699999999999996,66.42974809762191,11.8893,14.66,93.86436640560147,-6.135633594398525,-0.7333697484646589,-1.0084375395675702,0.1163328197226503,71259235,1.0
2241,ARWR,1541397600000,14.48,14.85,14.17,14.6,1573131,-0.009999999999999787,0.009999999999999787,0.0,66.22264039583149,11.8893,14.85,87.50295538217316,-12.497044617826843,-0.5899807508615478,-0.9247461818263657,0.1172839506172838,69686104,-1.0
2242,ARWR,1541484000000,14.79,14.97,14.32,14.4,1629698,0.3099999999999987,0.0,0.3099999999999987,69.61149249510564,11.8893,14.97,94.15717207128246,-5.842827928717547,-0.44618617213599165,-0.8290341798882909,0.23455759599332215,71315802,1.0
2243,ARWR,1541570400000,16.01,16.07,14.94,15.0,2839063,1.2200000000000024,0.0,1.2200000000000024,79.12287508146568,11.8893,16.07,98.5648336402995,-1.435166359700498,-0.23111992406408,-0.7094513287234487,0.2736674622116151,74154865,1.0
2244,ARWR,1541656800000,15.35,16.09,14.94,16.09,1806345,-0.6600000000000019,0.6600000000000019,0.0,66.19090699677673,11.8893,16.09,82.38388839955245,-17.61611160044755,-0.11263645316991422,-0.5900883536127418,0.21248025276461302,72348520,-1.0
2245,ARWR,1541743200000,14.49,15.2892,13.75,15.22,2037512,-0.8599999999999994,0.8599999999999994,0.0,53.1340678764016,11.8893,16.09,61.9111100530864,-38.0888899469136,-0.08712790399305703,-0.48949626368880483,0.18285714285714283,70311008,-1.0
2246,ARWR,1542002400000,12.83,14.49,12.81,14.49,1769391,-1.6600000000000001,1.6600000000000001,0.0,36.91566821162114,11.8893,16.09,22.393886733163516,-77.60611326683649,-0.19857131293974284,-0.4313112735389925,0.029695024077046384,68541617,-1.0
2247,ARWR,1542088800000,12.47,13.2836,12.35,12.94,1576228,-0.35999999999999943,0.35999999999999943,0.0,34.29614327845087,11.8893,16.09,13.823886495107965,-86.17611350489204,-0.3123395523560468,-0.4075169293024034,-0.019654088050314433,66965389,-1.0
2248,ARWR,1542175200000,12.06,12.83,11.84,12.62,1653694,-0.41000000000000014,0.41000000000000014,0.0,31.370862703800583,11.84,16.09,5.1764705882353095,-94.8235294117647,-0.43062133995435836,-0.41213781143279443,-0.15189873417721522,65311695,-1.0
2249,ARWR,1542261600000,12.98,13.1597,11.83,11.89,2011606,0.9199999999999999,0.0,0.9199999999999999,43.785229237207986,11.83,16.09,26.995305164319262,-73.00469483568074,-0.44499457807661,-0.41870916476155756,-0.10420979986197376,67323301,1.0
2250,ARWR,1542348000000,13.39,13.54,12.8,12.89,1666882,0.41000000000000014,0.0,0.41000000000000014,48.56914682068679,11.83,16.09,36.61971830985917,-63.380281690140826,-0.4184779464978998,-0.418662921108826,-0.07527624309392267,68990183,1.0
2251,ARWR,1542607200000,12.21,13.55,12.16,13.32,2023080,-1.1799999999999997,1.1799999999999997,0.0,37.86758986633357,11.83,16.09,8.92018779342725,-91.07981220657275,-0.4870648813431231,-0.43234331315568547,-0.17444219066937106,66967103,-1.0
2252,ARWR,1542693600000,12.3,12.73,11.5501,11.73,1755093,0.08999999999999986,0.0,0.08999999999999986,39.04946721092376,11.5501,16.09,16.517984977642687,-83.48201502235732,-0.5280709998013311,-0.45148885048481463,-0.23173016864459717,68722196,1.0
2253,ARWR,1542780000000,12.95,13.1,12.42,12.56,1040364,0.6499999999999986,0.0,0.6499999999999986,47.389129244908546,11.5501,16.09,30.835480957730326,-69.16451904226967,-0.5023285461239801,-0.4616567896126478,-0.1563517915309447,69762560,1.0
2254,ARWR,1542952800000,13.0,13.38,12.4049,12.76,561147,0.05000000000000071,0.0,0.05000000000000071,48.02038960582586,11.5501,16.09,31.93682680235247,-68.06317319764753,-0.4724468112674085,-0.4638147939435999,-0.1028295376121463,70323707,1.0
2255,ARWR,1543212000000,13.5,13.52,13.01,13.2,1234190,0.5,0.0,0.5,54.341617633024796,11.5501,16.09,42.950285248573756,-57.04971475142625,-0.4037651468550507,-0.4518048645258901,0.05222135619641466,71557897,1.0
2256,ARWR,1543298400000,13.42,13.87,13.2219,13.4,970489,-0.08000000000000007,0.08000000000000007,0.0,53.14838156942493,11.5501,16.09,41.188131897178344,-58.81186810282165,-0.35173518013345983,-0.431790927647404,0.07618283881315158,70587408,-1.0
2257,ARWR,1543384800000,14.8,14.86,13.47,13.5,1520496,1.3800000000000008,0.0,1.3800000000000008,67.39735666769457,11.5501,16.09,71.5852772087491,-28.414722791250895,-0.19687711381814665,-0.38480816488155256,0.22719734660033164,72107904,1.0
2258,ARWR,1543471200000,14.61,14.98,14.14,14.64,1024059,-0.19000000000000128,0.19000000000000128,0.0,64.29113432312363,11.5501,15.2892,81.83520098419406,-18.164799015805944,-0.08846265021047373,-0.32553906194733684,0.12557781201848983,71083845,-1.0
2259,ARWR,1543557600000,14.52,14.83,14.3035,14.5,1083385,-0.08999999999999986,0.08999999999999986,0.0,62.711439266386805,11.5501,14.98,86.58853027785064,-13.411469722149358,-0.009693909164427694,-0.262370031390755,0.08439133681852118,70000460,-1.0
2260,ARWR,1543816800000,15.09,15.13,14.4,15.02,1409940,0.5700000000000003,0.0,0.5700000000000003,68.38765769907259,11.5501,15.13,98.8826503533618,-1.1173496466381998,0.09760004903133712,-0.19037601530633655,0.23587223587223582,71410400,1.0
2261,ARWR,1543903200000,13.53,15.18,13.48,14.9,1757500,-1.5600000000000005,1.5600000000000005,0.0,46.18579018899324,11.5501,15.18,54.54420231962311,-45.45579768037689,0.056105571961113654,-0.14107969785284652,0.09999999999999987,69652900,-1.0
2262,ARWR,1544076000000,13.63,13.73,13.01,13.03,1561247,0.10000000000000142,0.0,0.10000000000000142,47.44769573522242,11.5501,15.18,57.2990991487369,-42.7009008512631,0.03093348222889425,-0.10667706183649836,0.05250965250965267,71214147,1.0
2263,ARWR,1544162400000,13.13,13.82,13.11,13.52,2106485,-0.5,0.5,0.0,41.79366402655752,11.5501,15.18,43.52461500316815,-56.475384996831856,-0.029026798506516016,-0.09114700917050189,0.010000000000000009,69107662,-1.0
2264,ARWR,1544421600000,13.66,13.8,12.89,13.16,1232993,0.5299999999999994,0.0,0.5299999999999994,49.197874695443865,11.5501,15.18,58.12556819747101,-41.874431802528996,-0.03339423461122415,-0.07959645425864635,0.01185185185185178,70340655,1.0
2265,ARWR,1544508000000,13.62,14.0,13.5784,13.85,1078993,-0.040000000000000924,0.040000000000000924,0.0,48.658857719379206,11.5501,15.18,57.02360946582549,-42.97639053417452,-0.03962633713434016,-0.07160243083378512,0.014903129657227954,69261662,-1.0
2266,ARWR,1544594400000,15.19,15.35,13.3327,13.5,2976190,1.5700000000000003,0.0,1.5700000000000003,65.68529908222332,12.4049,15.35,94.56724729211233,-5.4327527078876825,0.08118470841644765,-0.04104500298373856,0.02635135135135136,72237852,1.0
2267,ARWR,1544680800000,14.8,15.47,14.36,15.19,1815776,-0.3899999999999988,0.3899999999999988,0.0,59.98360652721114,12.4049,15.47,78.14100681870086,-21.858993181299134,0.1438009441127388,-0.0040758135644430775,0.013004791238877544,70422076,-1.0
2268,ARWR,1544767200000,14.32,15.0583,14.253,14.69,1272334,-0.4800000000000004,0.4800000000000004,0.0,53.40084286685327,12.89,15.47,55.426356589147275,-44.573643410852725,0.15292989306615112,0.027325327761675774,-0.01377410468319551,69149742,-1.0
2269,ARWR,1545026400000,13.96,14.68,13.81,14.2,1456934,-0.35999999999999943,0.35999999999999943,0.0,48.76924455265372,12.89,15.47,41.47286821705428,-58.52713178294573,0.1296214640628417,0.04778455502190897,-0.07488402915838299,67692808,-1.0
2270,ARWR,1545112800000,13.73,14.16,13.3547,14.13,1328978,-0.23000000000000043,0.23000000000000043,0.0,45.83844641355514,12.89,15.47,32.558139534883715,-67.44186046511629,0.09153512840976319,0.05653466969947982,0.014781966001478297,66363830,-1.0
2271,ARWR,1545199200000,13.45,14.37,13.26,13.71,2129425,-0.28000000000000114,0.28000000000000114,0.0,42.27021935366665,12.89,15.47,21.705426356589097,-78.2945736434109,0.038316089099726724,0.05289095357952919,-0.013206162876008953,64234405,-1.0
2272,ARWR,1545285600000,12.87,13.7,12.52,13.35,2221241,-0.5800000000000001,0.5800000000000001,0.0,35.639353025112726,12.52,15.47,11.864406779661001,-88.135593220339,-0.05008419616378568,0.03229592363086621,-0.01980198019801993,62013164,-1.0
2273,ARWR,1545372000000,11.21,12.91,11.14,12.91,3493429,-1.6599999999999984,1.6599999999999984,0.0,23.477207212735024,11.14,15.47,1.6166281755196372,-98.38337182448036,-0.2511945709765939,-0.024402175290625834,-0.1793557833089311,58519735,-1.0
2274,ARWR,1545631200000,10.74,11.13,10.41,10.98,1872566,-0.47000000000000064,0.47000000000000064,0.0,21.122370845567147,10.41,15.47,6.521739130434784,-93.47826086956522,-0.4433899406656767,-0.10819972836563604,-0.21145374449339205,56647169,-1.0
2275,ARWR,1545804000000,11.96,12.0,10.78,10.9,2537651,1.2200000000000006,0.0,1.2200000000000006,39.34434665264855,10.41,15.47,30.632411067193686,-69.36758893280631,-0.49159554455376053,-0.184878891603261,-0.2126398946675444,59184820,1.0
2276,ARWR,1545890400000,11.97,12.24,11.25,11.66,1968922,0.009999999999999787,0.0,0.009999999999999787,39.47658369513696,10.41,15.47,30.830039525691706,-69.16996047430828,-0.5229635186011485,-0.2524958170028385,-0.1912162162162162,61153742,1.0
2277,ARWR,1545976800000,11.94,12.31,11.74,11.97,1600297,-0.030000000000001137,0.030000000000001137,0.0,39.18090132798964,10.41,15.47,30.237154150197615,-69.76284584980239,-0.543973030813472,-0.31079125976496524,-0.1662011173184358,59553445,-1.0
2278,ARWR,1546236000000,12.42,12.565,12.01,12.16,1678440,0.4800000000000004,0.0,0.4800000000000004,46.56921475598079,10.41,15.47,39.72332015810276,-60.27667984189724,-0.5159437537613538,-0.35182175856424297,-0.11031518624641845,61231885,1.0
2279,ARWR,1546408800000,13.12,13.13,11.67,12.16,1895130,0.6999999999999993,0.0,0.6999999999999993,55.63751526412501,10.41,15.47,53.55731225296441,-46.4426877470356,-0.43226333730151545,-0.36791007431169753,-0.04442825928623462,63127015,1.0
2280,ARWR,1546495200000,12.05,13.05,11.95,12.9,2203169,-1.0699999999999985,1.0699999999999985,0.0,42.819754440823715,10.41,15.47,32.4110671936759,-67.5889328063241,-0.4471318047821988,-0.3837544204057978,-0.10408921933085491,60923846,-1.0
2281,ARWR,1546581600000,13.18,13.32,11.85,12.23,2659215,1.129999999999999,0.0,1.129999999999999,55.353354750236136,10.41,15.0583,59.59167867822646,-40.40832132177355,-0.3635429198119251,-0.37971212028702334,0.024087024087024123,63583061,1.0
2282,ARWR,1546840800000,14.11,14.29,12.86,13.21,1976960,0.9299999999999997,0.0,0.9299999999999997,63.0455306558254,10.41,14.68,86.65105386416862,-13.34894613583139,-0.21972207930705245,-0.3477141120910292,0.2586975914362175,65560021,1.0
2283,ARWR,1546927200000,14.5,14.58,13.75,14.23,2059551,0.39000000000000057,0.0,0.39000000000000057,65.88921661918292,10.41,14.58,98.08153477218225,-1.9184652278177474,-0.07342686721444736,-0.29285666311571285,0.35009310986964626,67619572,1.0
2284,ARWR,1547013600000,14.76,15.11,14.4701,14.6,3072468,0.2599999999999998,0.0,0.2599999999999998,67.79550170232439,10.41,15.11,92.55319148936171,-7.4468085106382915,0.06276940283390608,-0.22173144992578905,0.23411371237458178,70692040,1.0
2285,ARWR,1547100000000,15.0,15.04,14.03,14.64,1109012,0.2400000000000002,0.0,0.2400000000000002,69.60470872986727,10.41,15.11,97.65957446808513,-2.3404255319148817,0.18790586051366986,-0.13980398783789724,0.25313283208020043,71801052,1.0
2286,ARWR,1547186400000,14.87,15.2829,14.63,14.77,1261019,-0.13000000000000078,0.13000000000000078,0.0,67.24366977668225,10.41,15.2829,91.52660633298446,-8.473393667015545,0.27343549704465,-0.05715609086138777,0.24539363484087096,70540033,-1.0
2287,ARWR,1547445600000,14.22,14.73,14.02,14.56,1359840,-0.6499999999999986,0.6499999999999986,0.0,56.238088323534605,10.41,15.2829,78.18752693467957,-21.81247306532043,0.2854779701818959,0.011370721347268985,0.14492753623188404,69180193,-1.0
2288,ARWR,1547532000000,14.66,14.66,14.23,14.23,1085934,0.4399999999999995,0.0,0.4399999999999995,61.19829347267501,10.78,15.2829,86.16669257589554,-13.833307424104454,0.3267593611313817,0.07444844930409156,0.11737804878048785,70266127,1.0
2289,ARWR,1547618400000,14.51,15.02,14.5,14.76,954325,-0.15000000000000036,0.15000000000000036,0.0,58.58622038955125,11.25,15.2829,80.8351310471373,-19.164868952862705,0.3434127658865389,0.12824131262058105,0.20414937759336094,69311802,-1.0
2290,ARWR,1547704800000,14.63,14.92,14.24,14.43,956790,0.120000000000001,0.0,0.120000000000001,60.156028353736566,11.67,15.2829,81.92864457914698,-18.071355420853024,0.36211941899749434,0.17501693389596373,0.11001517450682852,70268592,1.0
2291,ARWR,1547791200000,14.52,14.96,14.1,14.62,1529987,-0.11000000000000121,0.11000000000000121,0.0,57.837201726609976,11.67,15.2829,78.88399900357054,-21.116000996429467,0.3638739829036428,0.21278834369749958,0.029057406094968208,68738605,-1.0
2292,ARWR,1548136800000,13.1,14.3,13.045,14.3,2092758,-1.42,1.42,0.0,36.741635902652675,11.67,15.2829,39.58039248249328,-60.41960751750671,0.24782557596010157,0.21979579015002,-0.096551724137931,66645847,-1.0
2293,ARWR,1548223200000,12.81,13.3221,12.5101,13.18,1478117,-0.28999999999999915,0.28999999999999915,0.0,33.833662199435295,11.85,15.2829,27.964694573101482,-72.03530542689852,0.13094633319844284,0.2020258987597046,-0.13211382113821135,65167730,-1.0
2294,ARWR,1548309600000,13.05,13.15,12.56,12.77,1469587,0.2400000000000002,0.0,0.2400000000000002,38.48297196279961,11.85,15.2829,34.95586821637686,-65.04413178362314,0.057027310135609355,0.17302618103488557,-0.13,66637317,1.0
2295,ARWR,1548396000000,13.72,13.79,12.99,13.1,2469571,0.6699999999999999,0.0,0.6699999999999999,49.83692307302977,12.5101,15.2829,43.6345931909983,-56.3654068090017,0.051910955177330464,0.14880313586337457,-0.0773369199731001,69106888,1.0
2296,ARWR,1548655200000,13.18,13.75,13.02,13.54,1166746,-0.5400000000000009,0.5400000000000009,0.0,42.536037125515875,12.5101,15.2829,24.15969417195615,-75.84030582804385,0.004233914070351119,0.11988929150476987,-0.07313642756680738,67940142,-1.0
2297,ARWR,1548741600000,13.2,13.32,13.01,13.18,1106436,0.019999999999999574,0.0,0.019999999999999574,42.89355160575785,12.5101,15.2829,24.880986728216953,-75.11901327178305,-0.0315727012026894,0.08959689296327801,-0.09959072305593453,69046578,1.0
2298,ARWR,1548828000000,13.62,13.63,13.17,13.35,1503330,0.41999999999999993,0.0,0.41999999999999993,50.37470211056359,12.5101,15.2829,40.02813040969416,-59.971869590305836,-0.025762240801046943,0.06652506621041303,-0.06133700895933847,70549908,1.0
2299,ARWR,1548914400000,14.12,14.15,13.4,13.64,1383048,0.5,0.0,0.5,57.9428808802288,12.5101,15.2829,58.06044431621464,-41.93955568378536,0.018969740878356234,0.057014001144001666,-0.03485987696514026,71932956,1.0
2300,ARWR,1549000800000,14.3,14.34,13.58,14.12,2112070,0.1800000000000015,0.0,0.1800000000000015,60.44842711962113,12.5101,15.02,71.31359815132082,-28.686401848679182,0.06815896024268575,0.05924299296373849,-0.015151515151515027,74045026,1.0
2301,ARWR,1549260000000,14.35,14.4224,14.03,14.2,621480,0.049999999999998934,0.0,0.049999999999998934,61.18949434846552,12.5101,15.02,73.3057093908124,-26.694290609187615,0.10990938612247092,0.06937627159548498,0.09541984732824438,74666506,1.0
2302,ARWR,1549346400000,13.81,14.505,13.7464,14.38,1110532,-0.5399999999999991,0.5399999999999991,0.0,49.606862089954845,12.5101,15.02,51.79090800430299,-48.209091995697,0.09829038206544816,0.07515909368947762,0.07806401249024209,73555974,-1.0
2303,ARWR,1549432800000,13.84,13.99,13.5,13.82,570588,0.02999999999999936,0.0,0.02999999999999936,50.21100428830076,12.5101,14.96,54.28384832033959,-45.71615167966041,0.09046021783715297,0.0782193185190127,0.06053639846743297,74126562,1.0
2304,ARWR,1549519200000,13.3,13.875,13.0,13.72,1642318,-0.5399999999999991,0.5399999999999991,0.0,40.20117025340623,12.5101,14.96,32.24213233193194,-67.75786766806804,0.04021766504210511,0.07061898782363119,-0.030612244897959218,72484244,-1.0
2305,ARWR,1549605600000,15.66,15.78,12.72,12.76,5605762,2.3599999999999994,0.0,2.3599999999999994,70.17955533378495,12.5101,15.78,96.33016300192668,-3.669836998073312,0.1886576288847781,0.09422671603586058,0.18816388467374812,78090006,1.0
2306,ARWR,1549864800000,16.92,17.0,15.22,15.66,3687390,1.2600000000000016,0.0,1.2600000000000016,77.21598382080478,12.5101,17.0,98.21822312300947,-1.7817768769905409,0.4033196218617885,0.1560452972010462,0.28181818181818197,81777396,1.0
2307,ARWR,1549951200000,17.35,17.45,16.57,17.03,2769844,0.4299999999999997,0.0,0.4299999999999997,79.1529767322343,12.56,17.45,97.95501022494891,-2.0449897750510817,0.6012078542809309,0.2450778086170232,0.27386196769456705,84547240,1.0
2308,ARWR,1550037600000,17.28,17.77,17.12,17.45,2197151,-0.07000000000000028,0.07000000000000028,0.0,77.90885729081371,12.72,17.77,90.29702970297032,-9.702970297029674,0.7438130750737191,0.3448248619083624,0.22379603399433434,82350089,-1.0
2309,ARWR,1550124000000,17.61,17.79,17.05,17.16,1463674,0.3299999999999983,0.0,0.3299999999999983,79.64885058291266,12.72,17.79,96.44970414201184,-3.5502958579881607,0.8733890962027946,0.45053770876724886,0.2314685314685314,83813763,1.0
2310,ARWR,1550210400000,17.92,17.93,17.54,17.71,1816853,0.3100000000000023,0.0,0.3100000000000023,81.24964156033619,12.72,17.93,99.80806142034552,-0.19193857965447242,0.9896849635088873,0.5583671597155766,0.24878048780487827,85630616,1.0
2311,ARWR,1550556000000,18.13,18.2657,17.57,17.82,1961591,0.2099999999999973,0.0,0.2099999999999973,82.33568687701712,12.72,18.2657,97.5530591268911,-2.4469408731088946,1.0862736348887054,0.6639484547502025,0.3128167994207096,87592207,1.0
2312,ARWR,1550642400000,18.1,18.54,17.66,18.25,1404435,-0.029999999999997584,0.029999999999997584,0.0,81.55702375210291,12.72,18.54,92.43986254295537,-7.560137457044637,1.1471761707572856,0.7605939979516192,0.30780346820809257,86187772,-1.0
2313,ARWR,1550728800000,18.02,18.1,17.57,17.84,1005926,-0.08000000000000185,0.08000000000000185,0.0,79.25090140092682,12.72,18.54,91.06529209621993,-8.934707903780064,1.1754368336660015,0.8435625650944958,0.3548872180451126,85181846,-1.0
2314,ARWR,1550815200000,18.4,18.41,17.92,18.0,1349988,0.379999999999999,0.0,0.379999999999999,82.03502832081332,12.72,18.54,97.59450171821304,-2.405498281786952,1.2144964774385034,0.9177493475632975,0.17496807151979565,86531834,1.0
2315,ARWR,1551074400000,19.12,19.26,18.65,18.83,1936361,0.7200000000000024,0.0,0.7200000000000024,86.10974067155057,12.72,19.26,97.85932721712537,-2.1406727828746264,1.288694244178803,0.9919383268863987,0.1300236406619384,88468195,1.0
2316,ARWR,1551160800000,19.15,19.36,18.9,19.0,2053024,0.029999999999997584,0.0,0.029999999999997584,86.25957360894633,12.72,19.36,96.83734939759034,-3.162650602409652,1.3345335857078915,1.0604573786506974,0.10374639769452432,90521219,1.0
2317,ARWR,1551247200000,19.7,19.8,19.09,19.09,1609587,0.5500000000000007,0.0,0.5500000000000007,88.81240923972848,12.72,19.8,98.58757062146891,-1.4124293785310935,1.3991138836464643,1.1281886796498508,0.14004629629629628,92130806,1.0
2318,ARWR,1551333600000,19.52,19.88,19.13,19.73,1560520,-0.17999999999999972,0.17999999999999972,0.0,82.98995737530359,12.72,19.88,94.97206703910615,-5.027932960893848,1.4194076910504272,1.186432481929966,0.10846110164679157,90570286,-1.0
2319,ARWR,1551420000000,20.18,20.25,19.73,19.77,1910742,0.6600000000000001,0.0,0.6600000000000001,86.6834904835784,15.22,20.25,98.60834990059641,-1.3916500994035843,1.4717813841291694,1.2435022623698069,0.1261160714285714,92481028,1.0
2320,ARWR,1551679200000,19.84,20.6,19.2,20.36,1845813,-0.33999999999999986,0.33999999999999986,0.0,76.77435716603786,16.57,20.6,81.14143920595531,-18.8585607940447,1.4689199598004912,1.2885858018559437,0.09431880860452302,90635215,-1.0
2321,ARWR,1551765600000,19.64,20.17,19.45,19.7,1727911,-0.1999999999999993,0.1999999999999993,0.0,71.24644108574101,17.05,20.6,72.95774647887322,-27.04225352112678,1.4339838585773244,1.31766541320022,0.08508287292817673,88907304,-1.0
2322,ARWR,1551852000000,18.0,19.715,17.8,19.64,2727292,-1.6400000000000006,1.6400000000000006,0.0,42.37704570138237,17.05,20.6,26.760563380281667,-73.23943661971833,1.2594443620861995,1.3060212029774159,-0.0011098779134295356,86180012,-1.0
2323,ARWR,1551938400000,18.13,18.53,17.79,17.96,1357008,0.129999999999999,0.0,0.129999999999999,44.4363141773784,17.54,20.6,19.281045751633968,-80.71895424836603,1.1187146213922254,1.2685598866603778,-0.014673913043478204,87537020,1.0
2324,ARWR,1552024800000,18.41,18.5,17.58,17.89,1415844,0.28000000000000114,0.0,0.28000000000000114,48.968602196233206,17.57,20.6,27.72277227722771,-72.2772277227723,1.0180435753045778,1.2184566243892179,-0.03713389121338917,88952864,1.0
2325,ARWR,1552280400000,19.06,19.15,18.43,18.74,1693130,0.6499999999999986,0.0,0.6499999999999986,58.119116782238244,17.57,20.6,49.174917491749106,-50.825082508250894,0.9794204642616471,1.1706493923637038,-0.004699738903394257,90645994,1.0
2326,ARWR,1552366800000,19.32,19.55,18.9,19.11,1284795,0.26000000000000156,0.0,0.26000000000000156,61.32022182946607,17.57,20.6,57.755775577557735,-42.244224422442265,0.9587394460447172,1.1282674030999065,-0.019289340101522834,91930789,1.0
2327,ARWR,1552453200000,19.3,19.68,19.19,19.45,1260291,-0.019999999999999574,0.019999999999999574,0.0,60.9070258928141,17.58,20.6,56.95364238410598,-43.046357615894024,0.9300151218457557,1.0886169468490763,-0.01127049180327866,90670498,-1.0
2328,ARWR,1552539600000,18.55,19.7,18.41,19.25,1508628,-0.75,0.75,0.0,47.15763360580824,17.58,20.6,32.11920529801329,-67.88079470198672,0.8370827866849595,1.038310114816253,-0.0807730426164519,89161870,-1.0
2329,ARWR,1552626000000,18.62,19.0,18.53,18.59,2504759,0.07000000000000028,0.0,0.07000000000000028,48.41178874688553,17.58,20.6,34.43708609271528,-65.56291390728471,0.7603171931920123,0.9827115304914049,-0.061491935483870885,91666629,1.0
2330,ARWR,1552885200000,18.88,19.4096,18.53,18.88,1464313,0.259999999999998,0.0,0.259999999999998,53.17470297173217,17.58,20.6,43.046357615894024,-56.95364238410598,0.7122493670280967,0.9286190977987434,-0.0386965376782078,93130942,1.0
2331,ARWR,1552971600000,18.83,19.03,18.54,18.94,1162444,-0.05000000000000071,0.05000000000000071,0.0,52.10721084372256,17.58,20.6,41.390728476821145,-58.609271523178855,0.6624839833723648,0.8753920749134678,0.04611111111111099,91968498,-1.0
2332,ARWR,1553058000000,18.54,19.0,18.27,18.79,897440,-0.28999999999999915,0.28999999999999915,0.0,45.935770764446325,17.58,20.6,31.78807947019867,-68.21192052980133,0.5928104322651571,0.8188757463838058,0.02261445118587968,91071058,-1.0
2333,ARWR,1553144400000,19.07,19.19,18.27,18.33,1117469,0.5300000000000011,0.0,0.5300000000000011,56.740143182399365,17.58,20.6,49.33774834437087,-50.66225165562912,0.5737464200604023,0.7698498811191252,0.03585008147745783,92188527,1.0
2334,ARWR,1553230800000,17.77,19.25,17.77,18.96,1632324,-1.3000000000000007,1.3000000000000007,0.0,36.24192304067585,17.58,20.17,7.335907335907375,-92.66409266409262,0.44856810371903677,0.7055935256391076,-0.06768100734522553,90556203,-1.0
2335,ARWR,1553490000000,18.07,18.2,17.27,17.71,1542899,0.3000000000000007,0.0,0.3000000000000007,41.83690914319918,17.27,19.715,32.71983640081802,-67.28016359918198,0.3693136609586176,0.6383375527030096,-0.06469979296066253,92099102,1.0
2336,ARWR,1553576400000,18.42,18.53,18.16,18.27,1109099,0.3500000000000014,0.0,0.3500000000000014,47.98179551382586,17.27,19.7,47.325102880658534,-52.674897119341466,0.3309312495537249,0.5768562920731527,-0.04559585492227969,93208201,1.0
2337,ARWR,1553662800000,17.76,18.45,17.56,18.4,1396528,-0.6600000000000001,0.6600000000000001,0.0,39.01358092193592,17.27,19.7,20.164609053498026,-79.83539094650197,0.24443869076664626,0.5103727718118514,-0.04258760107816706,91811673,-1.0
2338,ARWR,1553749200000,18.09,18.19,17.7,17.78,1000787,0.3299999999999983,0.0,0.3299999999999983,44.94975543268333,17.27,19.7,33.7448559670782,-66.25514403292179,0.20021302572490995,0.44834082259446306,-0.02846401718582181,92812460,1.0
2339,ARWR,1553835600000,18.35,18.45,18.0066,18.33,1101351,0.26000000000000156,0.0,0.26000000000000156,49.424999604990646,17.27,19.7,44.44444444444453,-55.55555555555547,0.18402239897426753,0.395477137870424,-0.028072033898304927,93913811,1.0
2340,ARWR,1554094800000,18.3,18.8699,18.145,18.54,1219104,-0.05000000000000071,0.05000000000000071,0.0,48.54924084646024,17.27,19.7,42.38683127572022,-57.61316872427978,0.16525170965145008,0.34943205222662926,-0.02814657461497594,92694707,-1.0
2341,ARWR,1554181200000,18.78,18.87,18.21,18.29,1163777,0.4800000000000004,0.0,0.4800000000000004,56.990729337320325,17.27,19.7,62.13991769547332,-37.86008230452668,0.18695271705162497,0.3169361851916284,0.012944983818770295,93858484,1.0
2342,ARWR,1554267600000,19.49,19.66,18.8,19.0,1558998,0.7099999999999973,0.0,0.7099999999999973,66.39958667216962,17.27,19.66,92.88702928870286,-7.112970711297141,0.2584625921702042,0.3052414665873436,0.02202412165705292,95417482,1.0
2343,ARWR,1554354000000,19.35,19.58,18.87,19.53,1178312,-0.13999999999999702,0.13999999999999702,0.0,63.25138573549736,17.27,19.66,87.02928870292894,-12.970711297071071,0.3003753137911893,0.30426823602811276,0.08891389983117626,94239170,-1.0
2344,ARWR,1554440400000,19.98,20.28,19.42,19.42,2042763,0.629999999999999,0.0,0.629999999999999,70.51105350073385,17.27,20.28,90.0332225913621,-9.966777408637892,0.3800462459576792,0.3194238380140261,0.1057000553403431,96281933,1.0
2345,ARWR,1554699600000,19.75,19.98,19.09,19.92,1272040,-0.23000000000000043,0.23000000000000043,0.0,65.09412888773355,17.27,20.28,82.39202657807306,-17.60797342192694,0.41978790225968865,0.3394966508631586,0.0722041259500541,95009893,-1.0
2346,ARWR,1554786000000,19.22,19.84,19.18,19.67,1674081,-0.5300000000000011,0.5300000000000011,0.0,54.05304535496729,17.27,20.28,64.78405315614613,-35.21594684385388,0.4038614175705959,0.3523696042046461,0.08220720720720709,93335812,-1.0
2347,ARWR,1554872400000,19.49,19.745,19.25,19.25,1080857,0.2699999999999996,0.0,0.2699999999999996,58.21873806632899,17.27,20.28,73.7541528239202,-26.245847176079813,0.4083194547220472,0.36355957430812635,0.07739082365948025,94416669,1.0
2348,ARWR,1554958800000,19.05,19.63,18.89,19.51,1126428,-0.4399999999999977,0.4399999999999977,0.0,49.739301429683394,17.27,20.28,59.13621262458473,-40.86378737541528,0.37205929061333975,0.3652595175691691,0.038147138964577554,93290241,-1.0
2349,ARWR,1555045200000,18.32,19.35,18.115,19.25,1915122,-0.7300000000000004,0.7300000000000004,0.0,38.89471692837397,17.56,20.28,27.941176470588267,-72.05882352941173,0.2811767199802411,0.34844295805138353,0.0010928961748633004,91375119,-1.0
2350,ARWR,1555304400000,18.65,18.8999,18.2,18.47,1149025,0.3299999999999983,0.0,0.3299999999999983,45.13426872410148,17.56,20.28,40.07352941176466,-59.92647058823534,0.23309291996862314,0.3253729504348315,-0.006922257720979874,92524144,1.0
2351,ARWR,1555390800000,19.25,19.42,18.76,18.93,1145108,0.6000000000000014,0.0,0.6000000000000014,54.81400822999184,17.7,20.28,60.077519379844944,-39.922480620155056,0.24062734537272235,0.3084238294224097,-0.012314007183170772,93669252,1.0
2352,ARWR,1555477200000,18.38,19.33,18.0,19.33,1401542,-0.870000000000001,0.870000000000001,0.0,42.32172620593629,18.0,20.28,16.666666666666615,-83.33333333333339,0.17438648384781885,0.28161636030749154,-0.05012919896640844,92267710,-1.0
2353,ARWR,1555563600000,18.17,18.57,17.5,18.32,1373032,-0.2099999999999973,0.2099999999999973,0.0,39.79571933399015,17.5,20.28,24.100719424460486,-75.89928057553952,0.10374892585718598,0.24604287341743042,-0.09059059059059049,90894678,-1.0
2354,ARWR,1555909200000,18.53,18.55,18.03,18.07,758284,0.35999999999999943,0.0,0.35999999999999943,46.15290042072628,17.5,20.28,37.05035971223024,-62.94964028776976,0.07594173454409514,0.2120226456427634,-0.061772151898734085,91652962,1.0
2355,ARWR,1555995600000,19.07,19.29,18.4275,18.64,1226127,0.5399999999999991,0.0,0.5399999999999991,54.47327351633005,17.5,20.28,56.47482014388488,-43.52517985611512,0.0963669637482596,0.18889150926386264,-0.007804370447450526,92879089,1.0
2356,ARWR,1556082000000,18.94,19.25,18.63,19.07,979298,-0.129999999999999,0.129999999999999,0.0,52.23140720193618,17.5,20.28,51.798561151079156,-48.201438848920844,0.10090106681425937,0.171293420773942,-0.028219599794766403,91899791,-1.0
2357,ARWR,1556168400000,19.05,19.17,18.66,18.9,812465,0.10999999999999943,0.0,0.10999999999999943,54.076664373476135,17.5,20.28,55.75539568345324,-44.24460431654676,0.11207848583386593,0.1594504337859268,0.0,92712256,1.0
2358,ARWR,1556254800000,19.0,19.1,18.76,19.09,759355,-0.05000000000000071,0.05000000000000071,0.0,53.00282651711683,17.5,19.98,60.48387096774193,-39.51612903225807,0.11556987126708762,0.15067432128215896,0.037117903930131035,91952901,-1.0
2359,ARWR,1556514000000,18.34,19.07,18.31,19.0,1053121,-0.6600000000000001,0.6600000000000001,0.0,40.69477501362018,17.5,19.84,35.89743589743589,-64.1025641025641,0.06433867898538637,0.13340719282280444,-0.016621983914208993,90899780,-1.0
2360,ARWR,1556600400000,17.98,18.4476,17.835,18.3,1152573,-0.35999999999999943,0.35999999999999943,0.0,35.505649157709314,17.5,19.745,21.380846325167045,-78.61915367483296,-0.0052508725627085084,0.10567557974570185,-0.06597402597402591,89747207,-1.0
2361,ARWR,1556686800000,17.43,18.1,17.41,18.0,1221475,-0.5500000000000007,0.5500000000000007,0.0,28.98933638551283,17.41,19.63,0.9009009009008822,-99.09909909909912,-0.10358740585455095,0.06382298262565128,-0.05168661588683343,88525732,-1.0
2362,ARWR,1556773200000,17.81,17.94,17.3,17.43,943311,0.379999999999999,0.0,0.379999999999999,38.05281390189321,17.3,19.42,24.0566037735848,-75.94339622641519,-0.14913782474874537,0.021230821150771937,-0.019812878370941256,89469043,1.0
2363,ARWR,1556859600000,18.14,18.19,17.73,17.9,1042223,0.33000000000000185,0.0,0.33000000000000185,45.077111600378274,17.3,19.42,39.62264150943394,-60.37735849056606,-0.15680111220438064,-0.01437556552025859,-0.021046950890447946,90511266,1.0
2364,ARWR,1557118800000,18.55,18.76,17.51,17.61,1131512,0.41000000000000014,0.0,0.41000000000000014,52.75672176924975,17.3,19.42,58.96226415094337,-41.03773584905663,-0.12831165237960818,-0.037162782892128515,-0.02726796014682742,91642778,1.0
2365,ARWR,1557205200000,18.01,18.54,17.68,18.27,1423289,-0.5399999999999991,0.5399999999999991,0.0,43.51096733027803,17.3,19.33,34.975369458128164,-65.02463054187184,-0.14760553254667386,-0.05925133282303759,-0.04910242872228088,90219489,-1.0
2366,ARWR,1557291600000,18.33,18.77,17.71,17.99,1337326,0.31999999999999673,0.0,0.31999999999999673,49.5557457358826,17.3,19.29,51.75879396984917,-48.241206030150835,-0.13551264056881607,-0.0745035943721933,-0.03779527559055129,91556815,1.0
2367,ARWR,1557378000000,19.45,19.565,17.75,18.23,1904025,1.120000000000001,0.0,1.120000000000001,64.77719823109277,17.3,19.565,94.92273730684319,-5.077262693156819,-0.035149119611162405,-0.06663269941998712,0.023684210526315752,93460840,1.0
2368,ARWR,1557464400000,19.51,19.99,19.05,19.22,1436509,0.060000000000002274,0.0,0.060000000000002274,65.42214456620576,17.3,19.99,82.15613382899637,-17.843866171003615,0.04867015315749157,-0.04357212890449137,0.06379498364231195,94897349,1.0
2369,ARWR,1557723600000,18.025,19.141,17.5565,18.98,1721394,-1.485000000000003,1.485000000000003,0.0,42.95878256914903,17.3,19.99,26.951672862453474,-73.04832713754652,-0.004675660521126446,-0.03579283522781839,0.0025027808676305607,93175955,-1.0
2370,ARWR,1557810000000,18.6,18.98,18.0,18.18,1303856,0.5750000000000028,0.0,0.5750000000000028,50.545366471802694,17.3,19.99,48.32713754646847,-51.67286245353153,-0.0005485839386629721,-0.028743984969987306,0.06712564543889865,94479811,1.0
2371,ARWR,1557896400000,19.17,19.285,18.2307,18.38,1068809,0.5700000000000003,0.0,0.5700000000000003,57.07544231663521,17.3,19.99,69.5167286245354,-30.48327137546459,0.04816121775909821,-0.0133629444241702,0.07636159460976999,95548620,1.0
2372,ARWR,1557982800000,19.47,19.69,18.51,18.96,1276915,0.29999999999999716,0.0,0.29999999999999716,60.26193047293063,17.3,19.99,80.66914498141264,-19.33085501858736,0.10970694595236807,0.011251033651137462,0.07331863285556772,96825535,1.0
2373,ARWR,1558069200000,19.46,19.95,19.2,19.2,1156985,-0.00999999999999801,0.00999999999999801,0.0,60.090361816226796,17.3,19.99,80.29739776951679,-19.702602230483198,0.1558785911641607,0.04017654515374212,0.049056603773584895,95668550,-1.0
2374,ARWR,1558328400000,18.94,19.38,18.82,19.15,999516,-0.5199999999999996,0.5199999999999996,0.0,51.32318507441574,17.3,19.99,60.96654275092944,-39.03345724907056,0.14879508138809072,0.06190025240061185,0.051637978900610726,94669034,-1.0
2375,ARWR,1558414800000,21.35,22.74,20.49,20.59,11601546,2.41,0.0,2.41,72.65683961952519,17.3,22.74,74.44852941176475,-25.551470588235247,0.3338003648239045,0.11628027488527042,0.16475722858701602,106270580,1.0
2376,ARWR,1558501200000,21.79,22.0983,21.17,21.17,4498258,0.4399999999999977,0.0,0.4399999999999977,74.96796157086649,17.51,22.74,81.8355640535373,-18.164435946462714,0.5100432465490954,0.19503286921803545,0.12030848329048838,110768838,1.0
2377,ARWR,1558587600000,21.97,22.08,20.42,21.47,21001496,0.17999999999999972,0.0,0.17999999999999972,75.92835176354825,17.51,22.74,85.27724665391969,-14.722753346080305,0.6566717920996012,0.28736065379434866,0.12608918503331612,131770334,1.0
2378,ARWR,1558674000000,24.04,24.3,21.91,21.96,5421125,2.0700000000000003,0.0,2.0700000000000003,84.04893139721204,17.5565,24.3,96.1444353822199,-3.8555646177801073,0.9291964726065771,0.4157278175567944,0.3337031900138696,137191459,1.0
2379,ARWR,1559019600000,25.02,25.39,24.08,24.4,3990011,0.9800000000000004,0.0,0.9800000000000004,86.53103093478995,17.5565,25.39,95.27669624050552,-4.723303759494491,1.2103004647689026,0.5746423469992161,0.34516129032258047,141181470,1.0
2380,ARWR,1559106000000,24.99,25.495,24.12,24.69,2029337,-0.030000000000001137,0.030000000000001137,0.0,86.05802794442027,17.5565,25.495,93.6385967122252,-6.3614032877748,1.4143528749841785,0.7425844525962086,0.30359937402190895,139152133,-1.0
2381,ARWR,1559192400000,24.6,25.2319,24.27,25.12,2062944,-0.389999999999997,0.389999999999997,0.0,79.53649467186551,17.5565,25.495,88.725829816716,-11.274170183283989,1.5269939043553187,0.8994663429480307,0.2634822804314332,137089189,-1.0
2382,ARWR,1559278800000,23.71,24.29,23.49,24.16,2369392,-0.8900000000000006,0.8900000000000006,0.0,66.30578722502715,17.5565,25.495,77.51464382440008,-22.48535617559992,1.526846632160595,1.0249424007905437,0.2183967112024665,134719797,-1.0
2383,ARWR,1559538000000,24.41,24.88,23.9,24.15,1990493,0.6999999999999993,0.0,0.6999999999999993,70.72521706215566,18.0,25.495,85.52368245496997,-14.47631754503003,1.565171742182816,1.132988269068998,0.28880675818373813,136710290,1.0
2384,ARWR,1559624400000,25.55,25.58,24.2673,24.78,2160966,1.1400000000000006,0.0,1.1400000000000006,76.51386567923605,18.2307,25.58,99.59179785829946,-0.40820214170053726,1.6683019937137722,1.240051013997953,0.19672131147540983,138871256,1.0
2385,ARWR,1559710800000,26.42,26.62,25.4,25.74,1743805,0.870000000000001,0.0,0.870000000000001,79.99680003128837,18.51,26.62,97.53390875462394,-2.46609124537607,1.7994917692013743,1.3519391650386374,0.21248279027076644,140615061,1.0
2386,ARWR,1559797200000,26.61,26.96,25.94,26.37,1403899,0.18999999999999773,0.0,0.18999999999999773,80.71737977795209,18.82,26.96,95.70024570024567,-4.2997542997543166,1.8969254477833744,1.460936421587585,0.2111970869367319,142018960,1.0
2387,ARWR,1559883600000,27.05,27.1,26.54,26.65,1318753,0.4400000000000013,0.0,0.4400000000000013,82.41048312404747,18.82,27.1,99.39613526570047,-0.6038647342995254,1.9867447065267179,1.566098078575412,0.12520798668885202,143337713,1.0
2388,ARWR,1560142800000,26.54,27.69,26.355,27.5,1278997,-0.5100000000000016,0.5100000000000016,0.0,73.74995125375038,20.42,27.69,84.18156808803299,-15.818431911967018,1.9937911946415738,1.6516367017886444,0.0607513988808952,142058716,-1.0
2389,ARWR,1560229200000,26.99,27.05,26.19,26.71,1098527,0.4499999999999993,0.0,0.4499999999999993,76.28705297297148,20.42,27.69,90.37138927097658,-9.628610729023423,2.012488116160135,1.723806984662943,0.08003201280512195,143157243,1.0
2390,ARWR,1560315600000,26.37,26.87,26.17,26.34,1822501,-0.6199999999999974,0.6199999999999974,0.0,66.12664114406385,20.42,27.69,81.84319119669877,-18.156808803301246,1.9547436744307056,1.7699943226164954,0.07195121951219519,141334742,-1.0
2391,ARWR,1560402000000,26.13,26.75,25.8608,26.54,1766501,-0.240000000000002,0.240000000000002,0.0,62.413782335338276,21.91,27.69,73.01038062283733,-26.989619377162665,1.8680807223699745,1.7896116025671915,0.10206663854913534,139568241,-1.0
2392,ARWR,1560488400000,25.82,26.1,25.69,26.1,1673263,-0.3099999999999987,0.3099999999999987,0.0,57.594203319255946,23.49,27.69,55.47619047619048,-44.52380952380952,1.7541643841757306,1.7825221588888993,0.05776321179844324,137894978,-1.0
2393,ARWR,1560747600000,26.45,26.57,25.95,26.01,2296732,0.629999999999999,0.0,0.629999999999999,64.09555403562982,23.49,27.69,70.47619047619045,-29.523809523809554,1.695179624802165,1.7650536520715525,0.03522504892367895,140191710,1.0
2394,ARWR,1560834000000,27.89,27.97,26.7,26.78,2103615,1.4400000000000013,0.0,1.4400000000000013,74.43324977863242,23.49,27.97,98.21428571428575,-1.7857142857142474,1.7445200027880645,1.760946922214855,0.055639666919000685,142295325,1.0
2395,ARWR,1560920400000,27.51,28.19,27.29,27.98,1925234,-0.379999999999999,0.379999999999999,0.0,68.43375222392697,23.49,28.19,85.53191489361703,-14.468085106382963,1.732983033941835,1.7553541445602512,0.03382187147688853,140370091,-1.0
2396,ARWR,1561006800000,27.29,28.315,27.1,27.82,1709770,-0.22000000000000242,0.22000000000000242,0.0,64.93728838980157,23.9,28.315,76.78369195922986,-23.216308040770137,1.6866451462823449,1.74161234490467,0.008872458410351225,138660321,-1.0
2397,ARWR,1561093200000,28.12,28.46,27.05,27.28,4373898,0.8300000000000018,0.0,0.8300000000000018,71.31682613294683,24.2673,28.46,91.89066711188495,-8.109332888115048,1.6973303323464677,1.7327559423930294,0.05953278070836476,143034219,1.0
2398,ARWR,1561352400000,27.5,28.28,27.33,28.13,2036861,-0.620000000000001,0.620000000000001,0.0,61.64895342466765,25.4,28.46,68.62745098039215,-31.37254901960785,1.6369004316007434,1.7135848402345721,0.018895887365691033,140997358,-1.0
2399,ARWR,1561438800000,27.52,27.9,27.24,27.69,1483692,0.019999999999999574,0.0,0.019999999999999574,61.8414914533828,25.69,28.46,66.06498194945843,-33.935018050541565,1.5724963733914095,1.68536714686594,0.04361016306408794,142481050,1.0
2400,ARWR,1561525200000,27.7,27.995,27.35,27.7,1003336,0.17999999999999972,0.0,0.17999999999999972,63.732309000697086,25.69,28.46,72.5631768953068,-27.436823104693204,1.5184761411944443,1.6519889457316408,0.06008419441255253,143484386,1.0
2401,ARWR,1561611600000,28.82,28.84,27.69,28.3,1281129,1.120000000000001,0.0,1.120000000000001,73.24909228729248,25.69,28.84,99.36507936507938,-0.6349206349206217,1.5481927553854788,1.6312297076624087,0.11618900077459338,144765515,1.0
2402,ARWR,1561698000000,26.5,28.3,26.05,28.2,3882670,-2.3200000000000003,2.3200000000000003,0.0,45.01613598528499,25.69,28.84,25.714285714285683,-74.2857142857143,1.368760555616248,1.5787358772531768,0.001890359168241984,140882845,-1.0
2403,ARWR,1561957200000,26.49,27.0,25.68,26.79,1554709,-0.010000000000001563,0.010000000000001563,0.0,44.93000676520994,25.68,28.84,25.63291139240502,-74.36708860759498,1.2117836406333318,1.505345429929208,-0.05019720329867339,139328136,-1.0
2404,ARWR,1562043600000,26.35,26.78,26.02,26.53,1233359,-0.13999999999999702,0.13999999999999702,0.0,43.58298319005773,25.68,28.84,21.20253164556967,-78.79746835443032,1.063818437833227,1.4170400315100118,-0.04216648491457653,138094777,-1.0
2405,ARWR,1562130000000,26.78,26.79,26.42,26.42,667066,0.4299999999999997,0.0,0.4299999999999997,49.00154530336781,25.68,28.84,34.81012658227852,-65.18987341772147,0.9700699919034186,1.3276460235886933,-0.01868816416269692,138761843,1.0
2406,ARWR,1562302800000,26.53,26.76,26.26,26.76,951526,-0.25,0.25,0.0,46.03544557619938,25.68,28.84,26.898734177215232,-73.10126582278477,0.8656224061532534,1.2352413001016054,-0.056543385490753884,137810317,-1.0
2407,ARWR,1562562000000,26.26,26.39,25.78,26.24,1199484,-0.2699999999999996,0.2699999999999996,0.0,42.8065232983393,25.68,28.84,18.354430379746894,-81.64556962025311,0.7523871477318593,1.1386704696276562,-0.04509090909090907,136610833,-1.0
2408,ARWR,1562648400000,26.78,26.96,26.18,26.18,727455,0.5199999999999996,0.0,0.5199999999999996,50.51895897138951,25.68,28.84,34.81012658227852,-65.18987341772147,0.696577333894794,1.0502518424810838,-0.026889534883720922,137338288,1.0
2409,ARWR,1562734800000,26.58,27.27,26.1767,26.96,1026837,-0.20000000000000284,0.20000000000000284,0.0,47.66641649866136,25.68,28.84,28.4810126582278,-71.5189873417722,0.6289590770834792,0.9659932894015629,-0.04043321299638991,136311451,-1.0
2410,ARWR,1562821200000,26.29,26.75,26.1,26.73,907195,-0.28999999999999915,0.28999999999999915,0.0,43.55205637978679,25.68,28.84,19.30379746835441,-80.69620253164558,0.5456802824069875,0.8819306880026478,-0.08778625954198482,135404256,-1.0
2411,ARWR,1562907600000,27.15,27.21,25.95,26.29,857973,0.8599999999999994,0.0,0.8599999999999994,56.42265908207482,25.68,28.84,46.51898734177211,-53.48101265822789,0.5428187733880101,0.8141083050797202,0.024528301886792336,136262229,1.0
2412,ARWR,1563166800000,27.8,27.98,26.94,27.27,710599,0.6500000000000021,0.0,0.6500000000000021,63.65054757867624,25.68,28.84,67.08860759493673,-32.91139240506326,0.5862427332917939,0.768535190722135,0.04945262363155911,136972828,1.0
2413,ARWR,1563253200000,28.16,28.33,27.6,27.81,737518,0.35999999999999943,0.0,0.35999999999999943,67.13417940153818,25.68,28.84,78.48101265822785,-21.518987341772142,0.6423014741475512,0.7432884474072183,0.06869070208728645,137710346,1.0
2414,ARWR,1563339600000,28.52,28.74,27.94,28.44,831778,0.35999999999999943,0.0,0.35999999999999943,70.40665447969057,25.68,28.84,89.87341772151898,-10.12658227848102,0.7076204138590754,0.7361548406975899,0.06497386109036585,138542124,1.0
2415,ARWR,1563426000000,29.63,30.13,28.4434,28.57,1457631,1.1099999999999994,0.0,1.1099999999999994,78.1476708483051,25.68,30.13,88.76404494382022,-11.235955056179778,0.8392791795719816,0.7567797084724683,0.11684885035808512,139999755,1.0
2416,ARWR,1563512400000,29.17,29.98,29.13,29.66,1132802,-0.4599999999999973,0.4599999999999973,0.0,69.45967815025924,25.68,30.13,78.42696629213489,-21.57303370786511,0.8961710424003613,0.784657975258047,0.11081492764661083,138866953,-1.0
2417,ARWR,1563771600000,29.98,30.73,29.15,29.28,1492781,0.8099999999999987,0.0,0.8099999999999987,75.08702933803457,25.78,30.73,84.84848484848484,-15.151515151515154,0.9951470484066363,0.8267557898877651,0.1194921583271098,140359734,1.0
2418,ARWR,1563858000000,29.78,30.3464,29.16,30.06,816586,-0.1999999999999993,0.1999999999999993,0.0,71.34189062772946,25.78,30.73,80.80808080808082,-19.19191919191918,1.0453972291989473,0.8704840777500017,0.12039127163280683,139543148,-1.0
2419,ARWR,1563944400000,29.23,29.6819,28.45,29.67,1373208,-0.5500000000000007,0.5500000000000007,0.0,61.59378012303949,25.78,30.73,69.69696969696969,-30.303030303030308,1.028979026353042,0.9021830674706098,0.11182959300114126,138169940,-1.0
2420,ARWR,1564030800000,28.79,29.37,28.69,29.23,1188855,-0.4400000000000013,0.4400000000000013,0.0,54.69515450881048,25.78,30.73,60.808080808080774,-39.191919191919226,0.9692897902047939,0.9156044120174467,0.060405156537753246,136981085,-1.0
2421,ARWR,1564117200000,29.52,29.635,29.01,29.02,1383584,0.7300000000000004,0.0,0.7300000000000004,62.693926999880865,25.95,30.73,74.68619246861924,-25.313807531380768,0.9697122998868828,0.926425989591334,0.06187050359712232,138364669,1.0
2422,ARWR,1564376400000,28.67,29.68,28.44,29.52,1079050,-0.8499999999999979,0.8499999999999979,0.0,50.67386532721095,25.95,30.73,56.90376569037661,-43.09623430962339,0.8911862057644555,0.9193780328259585,0.018110795454545414,137285619,-1.0
2423,ARWR,1564462800000,29.55,29.58,28.1,28.22,939721,0.879999999999999,0.0,0.879999999999999,59.86580958637399,25.95,30.73,75.31380753138076,-24.686192468619236,0.889706374691162,0.9134437011989993,0.036115007012622824,138225340,1.0
2424,ARWR,1564549200000,29.06,29.9,28.94,29.6,840027,-0.490000000000002,0.490000000000002,0.0,53.46465413540492,25.95,30.73,65.06276150627612,-34.937238493723875,0.8393195398081907,0.8986188689208375,-0.019237259534255813,137385313,-1.0
2425,ARWR,1564635600000,29.53,30.3,29.17,29.19,1110912,0.4700000000000024,0.0,0.4700000000000024,58.38888648029493,26.94,30.73,68.3377308707124,-31.662269129287584,0.8277706573237253,0.8844492266014151,0.01234144669180659,138496225,1.0
2426,ARWR,1564722000000,29.12,29.52,28.76,29.29,756012,-0.41000000000000014,0.41000000000000014,0.0,52.768522635795115,27.6,30.73,48.56230031948882,-51.43769968051119,0.776582551020244,0.862875891485181,-0.02868579052701803,137740213,-1.0
2427,ARWR,1564981200000,27.24,28.72,27.24,28.45,1701854,-1.8800000000000026,1.8800000000000026,0.0,34.96272558170955,27.24,30.73,0.0,-100.0,0.5776564557565997,0.8058320043394648,-0.08529214237743465,136038359,-1.0
2428,ARWR,1565067600000,28.5,29.8,27.83,28.28,2083211,1.2600000000000016,0.0,1.2600000000000016,48.42175265750369,27.24,30.73,36.10315186246421,-63.89684813753579,0.5157325183761756,0.747812107146807,-0.024974341430037628,138121570,1.0
2429,ARWR,1565154000000,28.75,28.96,28.0104,28.36,990989,0.25,0.0,0.25,50.75484646191455,27.24,30.73,43.266475644699156,-56.73352435530084,0.4812823393074517,0.694506153578936,-0.0013893713094824678,139112559,1.0
2430,ARWR,1565240400000,29.14,29.33,27.91,28.85,873567,0.39000000000000057,0.0,0.39000000000000057,54.4625644551121,27.24,30.73,54.44126074498571,-45.558739255014295,0.47991787035837064,0.6515884969348229,-0.01287262872628725,139986126,1.0
2431,ARWR,1565326800000,29.05,29.47,28.65,28.96,731019,-0.08999999999999986,0.08999999999999986,0.0,53.39216340538824,27.24,30.3464,58.2668040175123,-41.73319598248771,0.4662002052802201,0.6145108386039024,0.0132542727589815,139255107,-1.0
2432,ARWR,1565586000000,29.26,29.49,28.41,28.85,811376,0.21000000000000085,0.0,0.21000000000000085,55.73444468974242,27.24,30.3,66.01307189542489,-33.98692810457511,0.46689206078559664,0.5849870830402413,-0.009813874788494048,140066483,1.0
2433,ARWR,1565672400000,29.63,30.25,29.11,29.11,858438,0.36999999999999744,0.0,0.36999999999999744,59.837704074614514,27.24,30.3,78.10457516339865,-21.895424836601347,0.4916290750899712,0.5663154814501873,0.01961459050240877,140924921,1.0
2434,ARWR,1565758800000,29.78,30.11,28.84,28.93,1006449,0.15000000000000213,0.0,0.15000000000000213,61.50681184494394,27.24,30.3,83.00653594771245,-16.993464052287553,0.5173731281764233,0.5565270107954345,0.008465966813410164,141931370,1.0
2435,ARWR,1565845200000,29.18,30.06,29.14,29.9,740995,-0.6000000000000014,0.6000000000000014,0.0,51.6078526482977,27.24,30.3,63.39869281045751,-36.60130718954249,0.48378373241023453,0.5419783551183945,0.002060439560439553,141190375,-1.0
2436,ARWR,1565931600000,31.19,31.56,29.3,29.33,1569924,2.0100000000000016,0.0,2.0100000000000016,70.16694572443167,27.24,31.56,91.43518518518525,-8.564814814814756,0.6122959296599682,0.5560418700267092,0.1450073421439062,142760299,1.0
2437,ARWR,1566190800000,33.72,34.02,31.57,32.2,1715205,2.5299999999999976,0.0,2.5299999999999976,80.8393846613854,27.24,34.02,95.57522123893798,-4.424778761062006,0.9078277545176157,0.6263990469248906,0.18315789473684196,144475504,1.0
2438,ARWR,1566277200000,33.72,33.9,33.03,33.9,1514262,0.0,0.0,0.0,80.8393846613854,27.24,34.02,95.57522123893798,-4.424778761062006,1.1290241671038999,0.7269240709606926,0.17286956521739127,144475504,0.0
2439,ARWR,1566363600000,34.5,35.41,33.6399,33.9,1501413,0.7800000000000011,0.0,0.7800000000000011,83.29264459772887,27.24,35.41,88.86168910648719,-11.138310893512813,1.351682049704504,0.8518756667094549,0.18393960192175696,145976917,1.0
2440,ARWR,1566450000000,32.12,34.9338,31.805,34.6,1789019,-2.3800000000000026,2.3800000000000026,0.0,57.412330138804144,27.24,35.41,59.73072215422277,-40.26927784577723,1.3208677748223039,0.9456740883320247,0.10567986230636817,144187898,-1.0
2441,ARWR,1566536400000,30.88,32.7262,30.71,32.03,1163901,-1.2399999999999984,1.2399999999999984,0.0,48.37611573518705,27.83,35.41,40.23746701846967,-59.76253298153033,1.1827555335348556,0.9930903773725909,0.055365686944634174,143023997,-1.0
2442,ARWR,1566795600000,32.22,32.3,31.25,31.48,1884068,1.3399999999999999,0.0,1.3399999999999999,56.845281958509204,27.91,35.41,57.466666666666676,-42.533333333333324,1.1679638284403033,1.0280650675861334,0.08741140735740793,144908065,1.0
2443,ARWR,1566882000000,32.92,33.3382,32.271,32.66,1563063,0.7000000000000028,0.0,0.7000000000000028,60.72863702478655,27.91,35.41,66.80000000000005,-33.199999999999946,1.1989052124438295,1.0622330965576725,0.10543989254533237,146471128,1.0
2444,ARWR,1566968400000,34.36,34.84,32.79,32.8,1351443,1.4399999999999977,0.0,1.4399999999999977,67.6404719259998,28.41,35.41,85.00000000000003,-14.999999999999966,1.324356094925868,1.1146576962313117,0.17751884852638788,147822571,1.0
2445,ARWR,1567054800000,34.86,35.69,33.79,35.0,1309241,0.5,0.0,0.5,69.77195945733163,28.41,35.69,88.59890109890112,-11.401098901098882,1.447437486102089,1.1812136542054672,0.11766591856364217,149131812,1.0
2446,ARWR,1567141200000,34.17,36.8,33.68,35.61,1650124,-0.6899999999999977,0.6899999999999977,0.0,63.14869645972743,28.84,36.8,66.95979899497492,-33.040201005025075,1.472331026355807,1.2394371286355352,0.013345195729537407,147481688,-1.0
2447,ARWR,1567486800000,33.23,34.89,33.04,34.43,1285021,-0.9400000000000048,0.9400000000000048,0.0,54.94933238813173,28.84,36.8,55.150753768844204,-44.849246231155796,1.4000700561687616,1.2715637141421805,-0.014531435349940724,146196667,-1.0
2448,ARWR,1567573200000,34.24,34.26,33.09,33.55,1550285,1.0100000000000051,0.0,1.0100000000000051,61.19581795397009,29.14,36.8,66.579634464752,-33.420365535247996,1.4080699221912312,1.2988649557519907,-0.007536231884057942,147746952,1.0
2449,ARWR,1567659600000,31.84,34.7,30.8,34.58,2393595,-2.400000000000002,2.400000000000002,0.0,44.33948984690991,29.3,36.8,33.866666666666674,-66.13333333333333,1.2068382511582278,1.2804596148332381,-0.008717310087173025,145353357,-1.0
2450,ARWR,1567746000000,31.51,32.27,31.32,31.84,851099,-0.3299999999999983,0.3299999999999983,0.0,42.48294087225302,30.71,36.8,13.136288998357983,-86.86371100164202,1.0091001812473728,1.2261877281160651,0.02040155440414515,144502258,-1.0
2451,ARWR,1568005200000,28.7,31.59,27.63,31.45,2698905,-2.8100000000000023,2.8100000000000023,0.0,30.100026235532056,27.63,36.8,11.668484187568161,-88.33151581243183,0.618517930676223,1.1046537686280968,-0.10924891371818746,141803353,-1.0
2452,ARWR,1568091600000,28.72,28.95,27.81,28.42,1428673,0.019999999999999574,0.0,0.019999999999999574,30.26695014534016,27.63,36.8,11.886586695747003,-88.113413304253,0.30705300010707504,0.9451336149238925,-0.12758201701093563,143232026,1.0
2453,ARWR,1568178000000,30.89,30.92,28.78,28.78,1814086,2.1700000000000017,0.0,2.1700000000000017,46.31641884104411,27.63,36.8,35.5507088331516,-64.4492911668484,0.23263400322119665,0.8026336925833533,-0.10098952270081485,145046112,1.0
2454,ARWR,1568264400000,30.14,31.2,29.44,30.78,1351822,-0.75,0.75,0.0,42.42265767976913,27.63,36.8,27.371864776444955,-72.62813522355505,0.11184836174968282,0.6644766264166192,-0.1353987378083763,143694290,-1.0
2455,ARWR,1568350800000,29.95,30.46,29.61,30.01,846964,-0.19000000000000128,0.19000000000000128,0.0,41.40517001510708,27.63,36.8,25.29989094874592,-74.70010905125409,0.0007844163033432494,0.531738184393964,-0.12350014632718764,142847326,-1.0
2456,ARWR,1568610000000,29.44,31.4599,28.75,31.0,1631570,-0.509999999999998,0.509999999999998,0.0,38.54210510924348,27.63,36.8,19.738276990185415,-80.26172300981459,-0.12692419527203214,0.4000057084607648,-0.11405356605476968,141215756,-1.0
2457,ARWR,1568696400000,29.54,30.43,29.14,29.66,1011674,0.09999999999999787,0.0,0.09999999999999787,39.488757256483,27.63,36.8,20.828789531079615,-79.17121046892038,-0.21755716222970278,0.27649313432267125,-0.13726635514018704,142227430,1.0
2458,ARWR,1568782800000,29.28,29.67,28.45,29.67,1687715,-0.259999999999998,0.259999999999998,0.0,37.74458776680413,27.63,36.8,17.99345692475466,-82.00654307524535,-0.30682735386627513,0.15982903668488194,-0.08040201005025127,140539715,-1.0
2459,ARWR,1568869200000,29.09,29.69,28.95,29.31,1538232,-0.19000000000000128,0.19000000000000128,0.0,36.389343438556736,27.63,36.8,15.921483097055628,-84.07851690294437,-0.38842847433520333,0.05017753448086486,-0.07680101555061891,139001483,-1.0
2460,ARWR,1568955600000,28.86,29.53,28.3203,29.09,2600415,-0.23000000000000043,0.23000000000000043,0.0,34.65151354841933,27.63,34.89,16.942148760330582,-83.05785123966942,-0.46628201915461176,-0.0531143762462305,0.0055749128919859725,136401068,-1.0
2461,ARWR,1569214800000,28.88,29.1,28.63,29.1,1304357,0.019999999999999574,0.0,0.019999999999999574,34.963145970126604,27.63,34.7,17.680339462517672,-82.31966053748233,-0.5203691893788864,-0.1465653388727617,0.0055710306406684396,137705425,1.0
2462,ARWR,1569301200000,28.08,29.1,27.45,29.0,1832735,-0.8000000000000007,0.8000000000000007,0.0,28.656027547095846,27.45,34.7,8.689655172413776,-91.31034482758622,-0.6206327080517084,-0.24137881270855113,-0.09096795079313702,135872690,-1.0
2463,ARWR,1569387600000,28.26,28.66,27.58,28.0,1224333,0.18000000000000327,0.0,0.18000000000000327,31.84779202802561,27.45,32.27,16.80497925311207,-83.19502074688793,-0.6777550351252692,-0.32865405719189483,-0.06237558062375581,137097023,1.0
2464,ARWR,1569474000000,27.27,28.625,27.1,28.24,977229,-0.990000000000002,0.990000000000002,0.0,24.80527137805673,27.1,31.59,3.78619153674829,-96.21380846325171,-0.7937596499535466,-0.4216751757442253,-0.08948247078464111,136119794,-1.0
2465,ARWR,1569560400000,26.96,27.71,26.335,27.19,1207146,-0.3099999999999987,0.3099999999999987,0.0,22.97006296221211,26.335,31.4599,12.195359909461647,-87.80464009053836,-0.9003301071557175,-0.5174061620265238,-0.0842391304347826,134912648,-1.0
2466,ARWR,1569819600000,28.18,28.534000000000002,25.97,26.01,1378782,1.2199999999999989,0.0,1.2199999999999989,42.34113119264481,25.97,31.4599,40.25574236324888,-59.74425763675113,-0.876243370124314,-0.5891736036460818,-0.046039268788083954,136291430,1.0
2467,ARWR,1569906000000,28.14,28.87,27.5,28.1,1406322,-0.03999999999999915,0.03999999999999915,0.0,41.94211326922104,25.97,31.4599,39.52713164174212,-60.472868358257884,-0.8505771987165218,-0.6414543226601699,-0.03893442622950827,134885108,-1.0
2468,ARWR,1569992400000,28.92,29.45,27.115,27.85,1405576,0.7800000000000011,0.0,0.7800000000000011,52.098931239870005,25.97,31.4599,53.73504071112409,-46.26495928887591,-0.7585529652919973,-0.6648740511865354,-0.005843932622894399,136290684,1.0
2469,ARWR,1570078800000,29.92,29.94,28.26,29.3,939385,1.0,0.0,1.0,61.94677623806207,25.97,31.4599,71.95030874879326,-28.04969125120674,-0.5980376489019328,-0.6515067707296149,0.03672903672903671,137230069,1.0
2470,ARWR,1570165200000,30.6,30.68,29.55,29.61,899643,0.6799999999999997,0.0,0.6799999999999997,67.23241265607331,25.97,30.68,98.30148619957541,-1.698513800424592,-0.4112175275262189,-0.6034489220889357,0.059556786703601095,138129712,1.0
2471,ARWR,1570424400000,31.83,32.0334,30.4326,30.63,1258243,1.2299999999999969,0.0,1.2299999999999969,74.59682288962722,25.97,32.0334,96.64544644918689,-3.354553550813108,-0.1620425888127528,-0.5151676554336991,0.13354700854700852,139387955,1.0
2472,ARWR,1570510800000,31.48,32.22,31.145,31.51,1252374,-0.34999999999999787,0.34999999999999787,0.0,69.47051303793285,25.97,32.22,88.16000000000003,-11.839999999999975,0.007106352786824033,-0.4107128537895945,0.11394196744515206,138135581,-1.0
2473,ARWR,1570597200000,31.23,32.44,31.09,32.13,807046,-0.25,0.25,0.0,65.74677721925046,25.97,32.44,81.29829984544054,-18.701700154559468,0.11960644831029299,-0.30464899336961704,0.1452145214521452,137328535,-1.0
2474,ARWR,1570683600000,32.0,32.12,31.1482,31.28,939232,0.7699999999999996,0.0,0.7699999999999996,71.22767748202894,25.97,32.44,93.1993817619784,-6.800618238021603,0.26780901376816857,-0.19015739194205988,0.18694362017804145,138267767,1.0
2475,ARWR,1570770000000,32.55,32.86,31.83,32.29,1094768,0.5499999999999972,0.0,0.5499999999999972,74.58000056609826,25.97,32.86,95.5007256894049,-4.499274310595098,0.42474482415518366,-0.06717694872261115,0.1550745209368345,139362535,1.0
2476,ARWR,1571029200000,32.98,33.5,32.055,32.51,853631,0.4299999999999997,0.0,0.4299999999999997,76.9976676350729,25.97,33.5,93.0942895086321,-6.905710491367903,0.5771618285990812,0.061690806741727354,0.17199715707178376,140216166,1.0
2477,ARWR,1571115600000,34.345,34.3894,33.2145,33.25,872352,1.365000000000002,0.0,1.365000000000002,82.94055966685852,25.97,34.3894,99.47264650687694,-0.527353493123062,0.7988884066836235,0.20913032673010665,0.18758644536652835,141088518,1.0
2478,ARWR,1571202000000,34.51,34.74,34.0436,34.25,969386,0.16499999999999915,0.0,0.16499999999999915,83.53391588120083,25.97,34.74,97.37742303306723,-2.62257696693277,0.9766640629415022,0.3626370739723858,0.15340909090909083,142057904,1.0
2479,ARWR,1571288400000,36.6,37.33,34.51,34.97,2483475,2.0900000000000034,0.0,2.0900000000000034,89.08336398840311,25.97,37.33,93.57394366197185,-6.426056338028142,1.2715405564433517,0.544417770466579,0.196078431372549,144541379,1.0
2480,ARWR,1571374800000,35.95,38.75,35.6,36.89,3644756,-0.6499999999999986,0.6499999999999986,0.0,79.47192970772095,27.115,38.75,75.9346798452944,-24.065320154705603,1.4362268056947478,0.7227795775122129,0.12943763744894765,140896623,-1.0
2481,ARWR,1571634000000,36.5,36.89,35.03,36.37,1443118,0.5499999999999972,0.0,0.5499999999999972,81.42825693152278,27.115,38.75,80.66179630425441,-19.33820369574559,1.5927618806843569,0.8967760381466419,0.15946632782719194,142339741,1.0
2482,ARWR,1571720400000,38.975,39.25,36.88,37.12,2072022,2.4750000000000014,0.0,2.4750000000000014,87.5759955188505,28.26,39.25,97.4977252047316,-2.5022747952684132,1.894688086095762,1.0963584477364658,0.2479987191802755,144411763,1.0
2483,ARWR,1571806800000,39.65,40.09,38.0,38.89,1688115,0.6749999999999972,0.0,0.6749999999999972,88.74809691836799,29.55,40.09,95.8254269449715,-4.174573055028508,2.1634942232574517,1.3097856028406631,0.23906249999999996,146099878,1.0
2484,ARWR,1571893200000,36.87,38.87,36.38,38.81,2195360,-2.780000000000001,2.780000000000001,0.0,61.27638816491083,30.4326,40.09,66.65769254664812,-33.342307453351886,2.1276757355834803,1.4733636293892267,0.13271889400921655,143904518,-1.0
2485,ARWR,1571979600000,38.55,39.41,36.899,36.9,1427911,1.6799999999999997,0.0,1.6799999999999997,68.15082602131801,31.09,40.09,82.88888888888883,-17.111111111111175,2.2093828949775656,1.6205674825068945,0.168890236506974,145332429,1.0
2486,ARWR,1572238800000,39.26,39.49,38.2826,38.81,958109,0.7100000000000009,0.0,0.7100000000000009,70.68828771709153,31.09,40.09,90.77777777777773,-9.222222222222278,2.3048584996882795,1.757425685943172,0.14310671131169017,146290538,1.0
2487,ARWR,1572325200000,39.9,40.296,39.0,39.35,1089853,0.6400000000000006,0.0,0.6400000000000006,72.9313314833931,31.1482,40.296,95.67109031679747,-4.328909683202528,2.40444926121733,1.8868304009980037,0.15618661257606492,147380391,1.0
2488,ARWR,1572411600000,40.03,40.35,38.85,39.85,857563,0.13000000000000256,0.0,0.13000000000000256,73.408261411975,31.83,40.35,96.24413145539906,-3.755868544600941,2.4654454503216527,2.002553410862734,0.09371584699453561,148237954,1.0
2489,ARWR,1572498000000,40.05,40.65,39.6,40.04,1161062,0.01999999999999602,0.0,0.01999999999999602,73.49117252616568,32.055,40.65,93.01919720767886,-6.980802792321135,2.4867336845165298,2.099389465593493,0.11404728789986085,149399016,1.0
2490,ARWR,1572584400000,41.48,41.64,39.94,40.29,1511830,1.4299999999999997,0.0,1.4299999999999997,78.91487787692444,33.2145,41.64,98.10100290783924,-1.8989970921607466,2.589147729147655,2.1973411183043257,0.13643835616438338,150910846,1.0
2491,ARWR,1572847200000,39.46,42.29,38.65,41.75,1848286,-2.019999999999996,2.019999999999996,0.0,59.179682206280404,34.0436,42.29,65.68199456732637,-34.31800543267363,2.4787410948370336,2.2536211136108673,0.012443874278383671,149062560,-1.0
2492,ARWR,1572933600000,39.73,39.82,38.84,39.44,961303,0.269999999999996,0.0,0.269999999999996,60.6956281298197,34.51,42.29,67.0951156812339,-32.90488431876609,2.385530870293529,2.2800030649473997,0.002017654476670794,150023863,1.0
2493,ARWR,1573020000000,39.22,40.28,39.06,39.87,893807,-0.509999999999998,0.509999999999998,0.0,56.15079873528092,35.03,42.29,57.71349862258952,-42.28650137741049,2.2446336189241904,2.272929175742758,0.06373745592622737,149130056,-1.0
2494,ARWR,1573106400000,39.6,40.16,38.88,39.63,877472,0.38000000000000256,0.0,0.38000000000000256,58.80288878492848,35.03,42.29,62.94765840220388,-37.05234159779612,2.138977554530264,2.2461388515002594,0.027237354085603238,150007528,1.0
2495,ARWR,1573192800000,42.1,42.12,39.32,40.0,1166395,2.5,0.0,2.5,71.76587851758518,36.38,42.29,96.78510998307956,-3.2148900169204375,2.231252973543235,2.2431616759088544,0.07233825776872149,151173923,1.0
2496,ARWR,1573452000000,42.94,43.41,41.12,41.72,1045147,0.8399999999999963,0.0,0.8399999999999963,74.83568318156257,36.38,43.41,93.31436699857754,-6.685633001422464,2.345129692444644,2.2635552792160123,0.07619047619047614,152219070,1.0
2497,ARWR,1573538400000,45.275,45.85,42.905,43.23,1897540,2.335000000000001,0.0,2.335000000000001,81.34224270897862,36.38,45.85,93.92819429778244,-6.07180570221756,2.5938920255731546,2.329622628487441,0.13102672995253561,154116610,1.0
2498,ARWR,1573624800000,48.51,48.87,44.44,45.41,2660279,3.2349999999999994,0.0,3.2349999999999994,86.79876676374941,36.899,48.87,96.99273243672208,-3.0072675632779178,3.017293944399505,2.4671568916698536,0.21123595505617976,156776889,1.0
2499,ARWR,1573711200000,48.5,49.78,46.43,48.48,2075572,-0.00999999999999801,0.00999999999999801,0.0,86.70832041687908,38.2826,49.78,88.86704820220223,-11.132951797797775,3.3138362575039153,2.636492764836666,0.1692381870781101,154701317,-1.0
2500,ARWR,1573797600000,47.44,47.84,45.22,47.0,2376157,-1.0600000000000023,1.0600000000000023,0.0,76.90674915526117,38.65,49.78,78.97574123989216,-21.02425876010784,3.423847058283684,2.79396362352607,0.2022301064368981,152325160,-1.0
2501,ARWR,1574056800000,48.17,48.99,46.67,48.29,1632961,0.730000000000004,0.0,0.730000000000004,78.81013976232362,38.65,49.78,85.53459119496856,-14.465408805031437,3.5292532747546232,2.941021553771781,0.2124339290208912,153958121,1.0
2502,ARWR,1574143200000,50.5,51.84,48.89,49.29,2148810,2.3299999999999983,0.0,2.3299999999999983,83.74444157220886,38.65,51.84,89.84078847611825,-10.159211523881751,3.7574860281178317,3.1043144486409915,0.2876083630800612,156106931,1.0
2503,ARWR,1574229600000,48.35,50.37,46.93,50.0,3451140,-2.1499999999999986,2.1499999999999986,0.0,67.1067131473373,38.65,51.84,73.54056103108415,-26.459438968915848,3.7219705382671577,3.227845666566225,0.22095959595959602,152655791,-1.0
2504,ARWR,1574316000000,49.06,49.75,48.4,48.9,1404883,0.7100000000000009,0.0,0.7100000000000009,69.42155453613653,38.65,51.84,78.92342683851402,-21.076573161485975,3.7083675699993535,3.323950047252852,0.16532066508313537,154060674,1.0
2505,ARWR,1574402400000,49.2,49.77,47.9,49.39,964269,0.14000000000000057,0.0,0.14000000000000057,69.90344501634374,38.84,51.84,79.69230769230768,-20.307692307692314,3.666617465857904,3.3924835309738626,0.14578481602235693,155024943,1.0
2506,ARWR,1574661600000,56.99,59.72,52.58,53.19,5388868,7.789999999999999,0.0,7.789999999999999,85.03991031498647,38.88,59.72,86.90019193857967,-13.099808061420331,4.21354695730426,3.556696216239942,0.2587520706791828,160413811,1.0
2507,ARWR,1574748000000,67.7,67.77,58.5,58.94,6188105,10.71,0.0,10.71,91.678783937446,38.88,67.77,99.75770162686052,-0.24229837313947108,5.448394314337108,3.935035835859375,0.3955885384456814,166601916,1.0
2508,ARWR,1574834400000,69.02,70.28,64.5,67.0,3543782,1.3199999999999932,0.0,1.3199999999999932,92.17275499059676,39.32,70.28,95.93023255813952,-4.069767441860481,6.459076496464412,4.439843967980383,0.42309278350515456,170145698,1.0
2509,ARWR,1575007200000,73.01,73.72,67.81,69.25,2054453,3.990000000000009,0.0,3.990000000000009,93.5153578998788,41.12,73.72,97.82208588957057,-2.1779141104294286,7.495604399880797,5.050996054360466,0.5389966273187186,172200151,1.0
2510,ARWR,1575266400000,63.33,73.63,61.85,73.33,6145710,-9.680000000000007,9.680000000000007,0.0,63.179078709839736,42.905,73.72,66.28265455135485,-33.71734544864515,7.450085185749693,5.530813880638312,0.3147187045879176,166054441,-1.0
2511,ARWR,1575352800000,68.66,72.47,60.38,62.0,5939086,5.329999999999998,0.0,5.329999999999998,69.47110124413229,44.44,73.72,82.71857923497267,-17.28142076502733,7.754705913302253,5.975592287171101,0.3596039603960395,171993527,1.0
2512,ARWR,1575439200000,66.46,66.8858,61.0,62.22,6598302,-2.200000000000003,2.200000000000003,0.0,64.24276820935057,45.22,73.72,74.52631578947366,-25.473684210526333,7.729497584025168,6.326373346541915,0.3745604963805582,165395225,-1.0
2513,ARWR,1575525600000,65.53,66.77,62.5,66.0,2445986,-0.9299999999999926,0.9299999999999926,0.0,61.968012306888085,45.22,73.72,71.26315789473685,-28.73684210526315,7.547473991753662,6.570593475584266,0.3357113738279658,162949239,-1.0
2514,ARWR,1575612000000,67.27,69.0,65.7,66.43,1985868,1.7399999999999949,0.0,1.7399999999999949,64.66875784404327,46.67,73.72,76.15526802218113,-23.844731977818867,7.457655234369959,6.748005827341405,0.36727642276422756,164935107,1.0
2515,ARWR,1575871200000,67.77,69.5,66.5918,67.27,2088509,0.5,0.0,0.5,65.48150445133925,46.93,73.72,77.79022023142963,-22.209779768570375,7.342182928905586,6.866841247654241,0.1891559922793471,167023616,1.0
2516,ARWR,1575957600000,70.86,72.17,68.0,68.02,2281095,3.0900000000000034,0.0,3.0900000000000034,70.34578940359921,46.93,73.72,89.324374766704,-10.675625233296005,7.414537300078436,6.976380458139081,0.046676514032496286,169304711,1.0
2517,ARWR,1576044000000,68.22,71.8,67.28,70.62,1718444,-2.6400000000000006,2.6400000000000006,0.0,61.765421447582355,47.9,73.72,78.69868319132456,-21.301316808675445,7.176130755554858,7.016330517622237,-0.011590843233845183,167586267,-1.0
2518,ARWR,1576130400000,67.32,69.95,65.89,68.28,2050860,-0.9000000000000057,0.9000000000000057,0.0,58.93763257576164,47.9,73.72,75.21301316808673,-24.786986831913268,6.835770861634053,6.980218586424601,-0.0779345295165047,165535407,-1.0
2519,ARWR,1576216800000,66.46,68.5,65.56,66.7,1577018,-0.8599999999999994,0.8599999999999994,0.0,56.10551689654279,52.58,73.72,65.65752128666034,-34.342478713339666,6.4226026158370075,6.868695392307083,0.04942365387651981,163958389,-1.0
517,COST,1514959200000,190.58,192.1,188.38,188.82,3364378,2.2600000000000193,0.0,2.2600000000000193,68.01069067327794,185.4,195.35,52.06030150753782,-47.939698492462185,-0.04117755982639437,0.12024607850589548,0.011947114108214363,-7056089,1.0
518,COST,1515045600000,189.1,192.3,187.56099999999998,192.0,3525786,-1.4800000000000182,1.4800000000000182,0.0,56.43045758719819,185.4,195.35,37.185929648241135,-62.814070351758865,0.03223832891106326,0.10264452858692905,0.008479547757452854,-10581875,-1.0
519,COST,1515132000000,187.75,189.68,186.72,189.43,2819026,-1.3499999999999943,1.3499999999999943,0.0,47.85449608327056,185.4,195.35,23.618090452261274,-76.38190954773873,0.005663597083838567,0.08324834228631096,0.005085653104925036,-13400901,-1.0
520,COST,1515391200000,188.48,188.979,187.25,187.32,1962275,0.7299999999999898,0.0,0.7299999999999898,52.370765586947805,185.4,194.35,34.413407821228915,-65.58659217877108,0.030502097359288882,0.07269909330090656,0.009912661415635293,-11438626,1.0
521,COST,1515477600000,186.29,189.3,186.15,189.01,2241908,-2.1899999999999977,2.1899999999999977,0.0,40.29139196845377,185.4,193.0,11.710526315789304,-88.28947368421069,-0.08892927617461055,0.04037341940580313,-0.0013937282229966597,-13680534,-1.0
522,COST,1515564000000,185.42,186.24,183.88099999999997,185.75,2609522,-0.8700000000000045,0.8700000000000045,0.0,36.43888353480755,183.88099999999997,192.3,18.28008076968771,-81.71991923031229,-0.2354412197813076,-0.014789508431619035,-0.004723564143854109,-16290056,-1.0
523,COST,1515650400000,189.38,190.67,185.03,185.43,4678618,3.960000000000008,0.0,3.960000000000008,57.687278362752735,183.88099999999997,192.3,65.31654590806507,-34.683454091934934,-0.08739373023220764,-0.029310352791736764,0.014789411638623795,-11611438,1.0
524,COST,1515736800000,191.84,192.179,190.0,190.1,3499538,2.460000000000008,0.0,2.460000000000008,65.86636758464712,183.88099999999997,192.3,94.53616819099648,-5.463831809003514,0.190791072687432,0.014709932304097003,0.030732860520094496,-8111900,1.0
525,COST,1516082400000,191.53,192.84,190.89,192.35,2006574,-0.3100000000000023,0.3100000000000023,0.0,64.065697953296,183.88099999999997,192.84,85.37783234736023,-14.622167652639778,0.38309771979442075,0.08838748980216178,0.017045454545454586,-10118474,-1.0
526,COST,1516168800000,192.29,192.56,191.34,192.53,2585195,0.7599999999999909,0.0,0.7599999999999909,66.64515918059459,183.88099999999997,192.84,93.86092197789921,-6.139078022100787,0.5793317916380545,0.18657635016934038,0.008972609927589303,-7533279,1.0
527,COST,1516255200000,191.51,193.03,191.22,192.23,1907960,-0.7800000000000011,0.7800000000000011,0.0,61.423779849753004,183.88099999999997,193.03,83.38616242212258,-16.613837577877423,0.6712818903117466,0.28351745819782165,0.012744579587519844,-9441239,-1.0
528,COST,1516341600000,192.29,192.64,191.16,191.71,2353839,0.7800000000000011,0.0,0.7800000000000011,64.62192885249117,183.88099999999997,193.03,91.91168433708594,-8.088315662914052,0.789106856093639,0.38463533777698516,0.02418109187749673,-7087400,1.0
529,COST,1516600800000,194.38,194.76,192.06,192.5,3009122,2.0900000000000034,0.0,2.0900000000000034,71.83986908945586,183.88099999999997,194.76,96.50703189631405,-3.4929681036859526,1.0183324387827781,0.5113747579781439,0.031303056027164766,-4078278,1.0
530,COST,1516687200000,193.42,194.1,192.07,193.61,2316444,-0.960000000000008,0.960000000000008,0.0,64.82973637331163,183.88099999999997,194.76,87.68269142384409,-12.317308576155908,1.1169853000178023,0.6324968663860756,0.03827365934832794,-6394722,-1.0
531,COST,1516773600000,194.24,194.75,191.925,194.43,2799224,0.8200000000000216,0.0,0.8200000000000216,67.91539534685543,183.88099999999997,194.76,95.22014891074565,-4.779851089254351,1.239522790872826,0.7539020512834258,0.04756768417646429,-3595498,1.0
532,COST,1516860000000,197.95,198.45,194.735,195.0,3558701,3.7099999999999795,0.0,3.7099999999999795,77.9943337088174,183.88099999999997,198.45,96.56805546022376,-3.4319445397762336,1.5881568711956788,0.9207530152658766,0.04525293061569324,-36797,1.0
533,COST,1516946400000,198.91,199.23,195.69,197.75,2756240,0.960000000000008,0.0,0.960000000000008,79.88129642442797,183.88099999999997,199.23,97.91517362694643,-2.084826373053572,1.911614384743018,1.118925289161305,0.03685362802335268,2719443,1.0
534,COST,1517205600000,198.32,199.88,197.56,198.37,2031082,-0.5900000000000034,0.5900000000000034,0.0,75.30234553538222,183.88099999999997,199.88,90.24939058691169,-9.750609413088318,2.0989451442842153,1.3149292601858873,0.03545136532135951,688361,-1.0
535,COST,1517292000000,197.91,198.79,196.08,197.59,2285040,-0.4099999999999966,0.4099999999999966,0.0,71.99337306037089,183.88099999999997,199.88,87.68673042065132,-12.313269579348685,2.1908538707128855,1.4901141822912871,0.029226688855374716,-1596679,-1.0
536,COST,1517378400000,194.87,198.4747,194.1,197.44,2682299,-3.039999999999992,3.039999999999992,0.0,52.322923484097544,185.03,199.88,66.26262626262631,-33.73737373737369,2.0122661287063295,1.5945445715742959,0.017544775729726902,-4278978,-1.0
537,COST,1517464800000,193.47,195.4,192.44,193.41,2096563,-1.4000000000000057,1.4000000000000057,0.0,45.689462594410685,190.0,199.88,35.12145748987855,-64.87854251012145,1.7451734131088017,1.6246703398811972,0.006136564563939961,-6375541,-1.0
538,COST,1517551200000,190.99,193.6,190.8,191.25,2386573,-2.4799999999999898,2.4799999999999898,0.0,36.28649836357089,190.8,199.88,2.0925110132158378,-97.90748898678416,1.3305662900099264,1.5658495299069433,-0.017440065850396036,-8762114,-1.0
539,COST,1517810400000,182.77,192.1,182.525,190.66,3407221,-8.219999999999999,8.219999999999999,0.0,20.304953116612907,182.525,199.88,1.4116969173149219,-98.58830308268509,0.37278552752295013,1.3272367294301448,-0.05506152414434895,-12169335,-1.0
540,COST,1517896800000,185.01,185.24,176.2,178.91,4067910,2.2399999999999807,0.0,2.2399999999999807,29.998940078089817,176.2,199.88,37.204391891891895,-62.79560810810811,-0.21165168062341877,1.019459047419432,-0.04751853377265247,-8101425,1.0
541,COST,1517983200000,183.19,186.19,183.07,184.6,2594822,-1.8199999999999932,1.8199999999999932,0.0,26.928157830122387,176.2,199.88,29.518581081081113,-70.48141891891889,-0.8045677140191856,0.6546536951317083,-0.0745642839100783,-10696247,-1.0
542,COST,1518069600000,178.61,184.51,178.53,184.51,3013199,-4.579999999999984,4.579999999999984,0.0,20.75828100096672,176.2,199.88,10.177364864864966,-89.82263513513503,-1.6080022616991414,0.20212250376553828,-0.10205620632446832,-13709446,-1.0
543,COST,1518156000000,180.72,182.07,175.79,179.78,2777218,2.109999999999985,0.0,2.109999999999985,29.361768849959418,175.79,199.88,20.464923204649256,-79.53507679535075,-2.0572151794061995,-0.24974503286880942,-0.08874546187979027,-10932228,1.0
544,COST,1518415200000,181.06,183.25900000000001,180.38,181.84,1596154,0.3400000000000034,0.0,0.3400000000000034,30.75950498861812,175.79,199.88,21.87629721876301,-78.12370278123699,-2.3591991609829677,-0.6716358584916412,-0.08513970996917786,-9336074,1.0
545,COST,1518501600000,184.15,184.6,180.05,180.22,2123884,3.0900000000000034,0.0,3.0900000000000034,42.657855950515106,175.79,199.88,34.70319634703202,-65.29680365296798,-2.3310439455367487,-1.0035174759006629,-0.05501103299635657,-7212190,1.0
546,COST,1518588000000,187.35,188.48,182.31,182.71,2190997,3.1999999999999886,0.0,3.1999999999999886,52.42644094422628,175.79,199.88,47.98671647986717,-52.01328352013284,-2.035631076864348,-1.2099401960934,-0.03163281128857187,-5021193,1.0
547,COST,1518674400000,191.48,191.71,186.57,188.09,2072861,4.1299999999999955,0.0,4.1299999999999955,62.053213585897446,175.79,199.88,65.13075965130759,-34.86924034869242,-1.4618529893248535,-1.2603227547396907,0.002565579349704139,-2948332,1.0
548,COST,1518760800000,191.56,194.62,191.04,191.45,1970118,0.0800000000000125,0.0,0.0800000000000125,62.22406482728545,175.79,198.79,68.56521739130439,-31.434782608695606,-0.989625393605337,-1.20618328251282,0.04809323193084203,-978214,1.0
549,COST,1519106400000,188.12,191.48,187.63,189.87,2202139,-3.4399999999999977,3.4399999999999977,0.0,50.862092621008884,175.79,198.4747,54.35381556732071,-45.646184432679284,-0.8755506044930144,-1.140056746908859,0.016809902167450375,-3180353,-1.0
550,COST,1519192800000,185.75,189.14,185.69,188.53,1747191,-2.3700000000000045,2.3700000000000045,0.0,44.415014110994065,175.79,195.4,50.790413054564,-49.209586945435994,-0.9605539321348715,-1.1041561839540615,0.013974561930236273,-4927544,-1.0
551,COST,1519279200000,186.59,188.33,185.66,186.35,1360115,0.8400000000000034,0.0,0.8400000000000034,47.15441919086645,175.79,194.62,57.35528412108341,-42.6447158789166,-0.9506731442138516,-1.0734595760060195,0.04467834947651306,-3567429,1.0
552,COST,1519365600000,189.81,189.85,185.91,187.83,1561698,3.219999999999999,0.0,3.219999999999999,56.61222922046906,175.79,194.62,74.45565586829528,-25.544344131704722,-0.6806807717045444,-0.9949038151457245,0.05029880478087656,-2005731,1.0
553,COST,1519624800000,192.81,193.095,189.93,190.1,1852410,3.0,0.0,3.0,63.61294042848965,175.79,194.62,90.38767923526288,-9.612320764737127,-0.22685260771453386,-0.8412935736594863,0.06489561471335459,-153321,1.0
554,COST,1519711200000,190.1,195.52,190.1,193.45,2170354,-2.710000000000008,2.710000000000008,0.0,54.45480655039304,175.79,195.52,72.52914343639122,-27.470856563608777,-0.08102580782252744,-0.6892400204920945,0.03231061634537058,-2323675,-1.0
555,COST,1519797600000,190.9,193.76,190.89,191.6,2179803,0.8000000000000114,0.0,0.8000000000000114,56.583835534244116,175.79,195.52,76.5838824125697,-23.41611758743031,0.09685575789529821,-0.532020864814616,0.018948492127035088,-143872,1.0
556,COST,1519884000000,189.03,192.99,187.32,191.31,2447672,-1.8700000000000045,1.8700000000000045,0.0,50.248603247365544,175.79,195.52,67.10593005575265,-32.894069944247356,0.08825051732725342,-0.40796658838624206,-0.012795069981199059,-2591544,-1.0
557,COST,1519970400000,189.33,190.39,187.2162,187.48,2275923,0.30000000000001137,0.0,0.30000000000001137,51.25877257370649,180.05,195.52,59.98707175177764,-40.01292824822235,0.1040853777742825,-0.3055561951541372,-0.0116412612236374,-315621,1.0
558,COST,1520229600000,191.48,191.98,187.5,188.45,2155785,2.1499999999999773,0.0,2.1499999999999773,58.26596974012989,180.05,195.52,73.88493859082081,-26.11506140917919,0.284499105642368,-0.1875451349948361,0.017860939825643074,1840164,1.0
559,COST,1520316000000,191.46,192.25,190.0699,192.14,2458710,-0.01999999999998181,0.01999999999998181,0.0,58.17619944258118,182.31,195.52,69.26570779712338,-30.734292202876606,0.4209981426951117,-0.06583647945684652,0.030740242261103612,-618546,-1.0
560,COST,1520402400000,187.36,189.75,184.78,189.21,5157114,-4.099999999999994,4.099999999999994,0.0,42.637591267377786,184.78,195.52,24.02234636871518,-75.97765363128482,0.19983103886238496,-0.012702975793000209,0.004126694892545135,-5775660,-1.0
561,COST,1520488800000,185.69,186.3468,183.08,186.19,6061513,-1.670000000000016,1.670000000000016,0.0,37.88223670195671,183.08,195.52,20.98070739549828,-79.01929260450173,-0.10749571465194663,-0.031661523564789504,-0.021705916442758544,-11837173,-1.0
562,COST,1520575200000,188.58,188.64,184.22,186.5,3288116,2.890000000000015,0.0,2.890000000000015,49.19622029327959,183.08,195.52,44.212218649517695,-55.787781350482305,-0.11876045689453463,-0.049081310230738535,-0.021938696125719526,-8549057,1.0
563,COST,1520830800000,189.37,190.09900000000002,187.55,188.27,2394059,0.789999999999992,0.0,0.789999999999992,51.956250193858274,183.08,195.52,50.56270096463017,-49.43729903536983,-0.06378790615914909,-0.052022629416420656,-0.0038400841662282748,-6154998,1.0
564,COST,1520917200000,187.46,190.12,186.8,190.05,1964324,-1.9099999999999966,1.9099999999999966,0.0,45.11831722819284,183.08,195.52,35.20900321543405,-64.79099678456595,-0.17106554874180802,-0.07583121328149814,-0.018019905709795725,-8119322,-1.0
565,COST,1521003600000,184.63,189.01,183.5,188.78,2865997,-2.8300000000000125,2.8300000000000125,0.0,36.83119375302353,183.08,195.52,12.459807073954849,-87.54019292604515,-0.47713244736786464,-0.15609146009877148,-0.02327672856160401,-10985319,-1.0
566,COST,1521090000000,185.51,186.57,184.16,184.82,1811346,0.8799999999999955,0.0,0.8799999999999955,40.73672998250565,183.08,195.52,19.53376205787764,-80.46623794212235,-0.6417721993194618,-0.25322760794290955,-0.020176411556541596,-9173973,1.0
567,COST,1521176400000,185.87,186.25,184.47,186.18,3569415,0.36000000000001364,0.0,0.36000000000001364,42.41722912695467,183.08,195.52,22.42765273311891,-77.5723472668811,-0.7349055575733985,-0.34956319786900736,-0.02929809901817415,-5604558,1.0
568,COST,1521435600000,184.15,185.98,182.81,185.63,2493194,-1.7199999999999989,1.7199999999999989,0.0,36.68281340830199,182.81,193.76,12.237442922374472,-87.76255707762553,-0.9358345101140912,-0.46681746031802424,-0.03818029875692053,-8097752,-1.0
569,COST,1521522000000,187.35,187.58,184.6,185.1,1852528,3.1999999999999886,0.0,3.1999999999999886,50.9249988324994,182.81,192.99,44.59724950884076,-55.402750491159246,-0.8287760198299736,-0.5392091722204142,-5.337318531184465e-05,-6245224,1.0
570,COST,1521608400000,186.07,187.89,186.06,186.83,2048277,-1.2800000000000011,1.2800000000000011,0.0,46.13541922807799,182.81,192.25,34.53389830508466,-65.46610169491535,-0.8370129959981796,-0.5987699369759674,0.0020464214551132454,-8293501,-1.0
571,COST,1521694800000,182.64,185.5464,182.503,184.9,2489798,-3.430000000000007,3.430000000000007,0.0,35.74165087351997,182.503,192.25,1.4055606853390812,-98.59443931466092,-1.1061812828215807,-0.7002522061450901,-0.03149856824689801,-10783299,-1.0
572,COST,1521781200000,180.84,184.45,180.83,183.28,2351798,-1.799999999999983,1.799999999999983,0.0,31.451207470227644,180.83,192.25,0.08756567425561222,-99.91243432574439,-1.447370106519685,-0.849675786220009,-0.045044093573427646,-13135097,-1.0
573,COST,1522040400000,187.22,187.56,182.335,183.03,2036617,6.3799999999999955,0.0,6.3799999999999955,54.02293829374733,180.83,190.12,68.78363832077494,-31.216361679225063,-1.191380120354978,-0.9180166530470029,-0.0012802731249333954,-11098480,1.0
574,COST,1522126800000,183.15,187.66,182.06,187.44,2495310,-4.069999999999993,4.069999999999993,0.0,43.48362270125415,180.83,190.12,24.973089343379925,-75.02691065662007,-1.3006376018317667,-0.9945408428039556,-0.008016032064128154,-13593790,-1.0
575,COST,1522213200000,183.61,184.62,181.23,183.61,2168656,0.46000000000000796,0.0,0.46000000000000796,44.88581924762471,180.83,190.12,29.92465016146398,-70.07534983853603,-1.3348417996485296,-1.0626010341728704,-0.01024203546978586,-11425134,1.0
576,COST,1522299600000,188.43,188.64,184.41,184.74,3015962,4.819999999999993,0.0,4.819999999999993,57.603359822045235,180.83,190.12,81.80839612486545,-18.191603875134543,-0.9632146719620209,-1.0427237617307006,0.013773067197503597,-8409172,1.0
577,COST,1522645200000,182.75,186.91,181.05,186.91,3599186,-5.680000000000007,5.680000000000007,0.0,43.84638908927189,180.83,190.12,20.667384284176418,-79.33261571582358,-1.1127733181599808,-1.0567336730165566,-0.007602497963616672,-12008358,-1.0
578,COST,1522731600000,182.61,184.17,181.35,183.53,2287002,-0.13999999999998636,0.13999999999998636,0.0,43.550590124939355,180.83,189.01,21.760391198044083,-78.23960880195592,-1.2283930677633919,-1.0910655519659238,-0.0253002401921536,-14295360,-1.0
579,COST,1522818000000,185.52,186.35,180.94,181.13,2111406,2.9099999999999966,0.0,2.9099999999999966,51.412066351832785,180.83,188.64,60.05121638924473,-39.94878361075527,-1.073455330738824,-1.0875435077205038,-0.0029558768205513175,-12183954,1.0
580,COST,1522904400000,186.25,187.0,184.93,186.7,1933629,0.7299999999999898,0.0,0.7299999999999898,53.29479512007908,180.83,188.64,69.39820742637652,-30.601792573623488,-0.8817421538669521,-1.0463832369497934,0.01976565922032414,-10250325,1.0
581,COST,1522990800000,183.96,187.25,183.1,185.34,2259047,-2.289999999999992,2.289999999999992,0.0,46.739345494346374,180.83,188.64,40.076824583866916,-59.92317541613309,-0.903750583555734,-1.0178567062709816,0.01725282017252816,-12509372,-1.0
582,COST,1523250000000,184.41,187.4,183.5,185.2,1946009,0.44999999999998863,0.0,0.44999999999998863,48.184461274902375,180.83,188.64,45.83866837387959,-54.161331626120415,-0.8748693671989258,-0.9892592384565704,-0.015009080226471516,-10563363,1.0
583,COST,1523336400000,183.55,185.97,182.17,185.75,2527526,-0.8599999999999852,0.8599999999999852,0.0,45.46426546350128,180.83,188.64,34.82714468629972,-65.17285531370028,-0.9107379563978952,-0.9735549820448355,0.002184002184002276,-13090889,-1.0
584,COST,1523422800000,184.65,186.37,182.22,182.25,1697263,1.0999999999999943,0.0,1.0999999999999943,49.658577919080734,180.83,188.64,48.91165172855321,-51.08834827144678,-0.8408682706042043,-0.9470176397567094,0.005664179510919798,-11393626,1.0
585,COST,1523509200000,188.82,190.04,185.4948,185.5,2841623,4.1699999999999875,0.0,4.1699999999999875,62.330898500195765,180.83,190.04,86.75352877307273,-13.24647122692727,-0.4444549626889511,-0.8465051043431578,0.0020697341187707607,-8552003,1.0
586,COST,1523595600000,188.91,189.83,187.01,189.81,1744406,0.09000000000000341,0.0,0.09000000000000341,62.565567802851206,180.94,190.04,87.58241758241763,-12.417582417582375,-0.12164655355562104,-0.7015333941856504,0.033707250341997286,-6807597,1.0
587,COST,1523854800000,194.58,195.8,191.38,191.84,3026826,5.670000000000016,0.0,5.670000000000016,74.2338885465443,180.94,195.8,91.79004037685063,-8.209959623149379,0.5843010804445328,-0.44436649925961375,0.06554953178905865,-3780771,1.0
588,COST,1523941200000,196.0,196.88,194.73,195.66,2160451,1.4199999999999875,0.0,1.4199999999999875,76.36292921143946,180.94,196.88,94.47929736511924,-5.5207026348807755,1.2438486830491513,-0.10672346279786064,0.056489866321690396,-1620320,1.0
589,COST,1524027600000,196.51,197.766,196.12,196.3,1663116,0.5099999999999909,0.0,0.5099999999999909,77.14552248567489,180.94,197.766,92.535361939855,-7.464638060145018,1.7870353823366258,0.2720283062290368,0.05508724832214762,42796,1.0
590,COST,1524114000000,195.07,196.4,193.5001,196.16,2427563,-1.4399999999999977,1.4399999999999977,0.0,69.63437390167127,180.94,197.766,83.97717817663141,-16.02282182336859,2.077493866684847,0.633121418320199,0.06039356381822136,-2384767,-1.0
591,COST,1524200400000,193.56,195.67,192.75,194.43,2252819,-1.509999999999991,1.509999999999991,0.0,62.29572311943052,180.94,197.766,75.00297159158451,-24.997028408415492,2.1610509095413875,0.9387073165644368,0.049617699690906125,-4637586,-1.0
592,COST,1524459600000,193.35,194.38,192.26,193.81,1618030,-0.21000000000000796,0.21000000000000796,0.0,61.25972763499947,180.94,197.766,73.75490312611436,-26.245096873885643,2.1851480471610216,1.1879954626837539,0.053391446472350834,-6255616,-1.0
593,COST,1524546000000,192.51,195.36,191.15,194.54,1598903,-0.8400000000000034,0.8400000000000034,0.0,56.89290419563559,182.17,197.766,66.29905103872788,-33.70094896127212,2.1121742306554268,1.3728312162780887,0.042567018683996594,-7854519,-1.0
594,COST,1524632400000,193.97,194.67,191.39,192.23,1311650,1.460000000000008,0.0,1.460000000000008,62.284658482748824,182.17,197.766,75.66042575019242,-24.339574249807587,2.1472969085297393,1.527724354728419,0.027274653108780855,-6542869,1.0
595,COST,1524718800000,195.26,196.44,193.34,194.12,1445836,1.289999999999992,0.0,1.289999999999992,66.55007317825897,182.17,197.766,83.93177737881508,-16.068222621184916,2.253166223313116,1.6728127284453584,0.03361389021227046,-5097033,1.0
596,COST,1524805200000,196.58,196.92,194.53,194.95,1563272,1.3200000000000216,0.0,1.3200000000000216,70.4904514003787,182.17,197.766,92.39548602205707,-7.604513977942924,2.4156543005975664,1.8213810428758002,0.010278548668927856,-3533761,1.0
597,COST,1525064400000,197.16,199.04,196.3852,197.1,2164979,0.5799999999999841,0.0,0.5799999999999841,72.15353752023785,182.22,199.04,88.82282996432819,-11.177170035671796,2.561663643057642,1.9694375629121688,0.0059183673469387355,-1368782,1.0
598,COST,1525150800000,196.55,197.08,193.5149,196.49,1413235,-0.6099999999999852,0.6099999999999852,0.0,67.53473771909206,185.4948,199.04,81.61710421403906,-18.382895785960944,2.598231029212542,2.0951962561722435,0.00020355198208754643,-2782017,-1.0
599,COST,1525237200000,194.0,195.58,192.45,195.48,2498065,-2.5500000000000114,2.5500000000000114,0.0,51.60183490290381,187.01,199.04,58.104738154613536,-41.895261845386464,2.3939662892870217,2.1549502627951993,-0.005485210437278898,-5280082,-1.0
600,COST,1525323600000,193.01,193.99,190.18,193.916,1815453,-0.9900000000000091,0.9900000000000091,0.0,46.6695903761941,190.18,199.04,31.94130925507888,-68.05869074492112,2.1277145437439913,2.1495031189849576,-0.002841496176896108,-7095535,-1.0
601,COST,1525410000000,195.19,196.4,191.28,192.84,1704452,2.180000000000007,0.0,2.180000000000007,57.090432136425726,190.18,199.04,56.54627539503385,-43.45372460496615,2.06868218007034,2.1333389312020343,0.009516420998189723,-5391083,1.0
602,COST,1525669200000,193.06,195.795,192.21,195.78,2361852,-2.1299999999999955,2.1299999999999955,0.0,46.78423528372443,190.18,199.04,32.505643340857794,-67.49435665914221,1.8290185036070454,2.0724748456830366,0.0028569944418472826,-7752935,-1.0
603,COST,1525755600000,194.48,195.2,192.42,192.99,1908637,1.4199999999999875,0.0,1.4199999999999875,53.272968815244774,190.18,199.04,48.53273137697506,-51.46726862302494,1.7336324317195135,2.004706362890332,0.002629272567922891,-5844298,1.0
604,COST,1525842000000,196.04,196.42,193.15,194.15,1999075,1.5600000000000023,0.0,1.5600000000000023,59.528361528709134,190.18,199.04,66.13995485327308,-33.86004514672692,1.7635381796958427,1.9564727262514343,0.003994673768308976,-3845223,1.0
605,COST,1525928400000,195.45,196.93,194.2,196.05,1874181,-0.5900000000000034,0.5900000000000034,0.0,56.242663904928456,190.18,199.04,59.48081264108341,-40.51918735891659,1.7198215226052298,1.9091424855221937,-0.005748295859192343,-5719404,-1.0
606,COST,1526014800000,195.76,195.98,194.57,195.33,1296311,0.3100000000000023,0.0,0.3100000000000023,57.659492497975315,190.18,199.04,62.97968397291189,-37.020316027088114,1.6906916122891857,1.8654523108755925,-0.0071008318117264935,-4423093,1.0
607,COST,1526274000000,195.88,197.27,195.42,195.96,1440877,0.12000000000000455,0.0,0.12000000000000455,58.263099256070944,190.18,199.04,64.33408577878102,-35.66591422121898,1.658170690371918,1.8239959867748576,-0.0034088018315950874,-2982216,1.0
608,COST,1526360400000,195.48,196.7,193.26,194.76,2319581,-0.4000000000000057,0.4000000000000057,0.0,55.234544280883824,190.18,199.04,59.8194130925507,-40.1805869074493,1.5818943517795105,1.7755756597757884,0.007628865979381283,-5301797,-1.0
609,COST,1526446800000,198.71,199.35,195.0,196.07,2163192,3.230000000000018,0.0,3.230000000000018,69.84109986296085,190.18,199.35,93.02071973827712,-6.97928026172287,1.7617010953760825,1.7728007468958473,0.029532148593337304,-3138605,1.0
610,COST,1526533200000,199.6,201.35,197.89,199.06,2391034,0.8899999999999864,0.0,0.8899999999999864,72.67568484865777,190.18,201.35,84.33303491495074,-15.666965085049256,1.9534773627240156,1.8089360700614812,0.02259337056201649,-747571,1.0
611,COST,1526619600000,198.96,199.52,197.7801,199.5,1624611,-0.6399999999999864,0.6399999999999864,0.0,67.4180766860925,190.18,201.35,78.60340196956143,-21.396598030438575,2.030423813634542,1.8532336187760932,0.030560447529265566,-2372182,-1.0
612,COST,1526878800000,199.62,201.34,199.09,199.6,1202798,0.6599999999999966,0.0,0.6599999999999966,70.00048649839269,190.18,201.35,84.51208594449426,-15.487914055505744,2.1202082532830673,1.906628545677488,0.026429452900041284,-1169384,1.0
613,COST,1526965200000,198.97,201.77,198.83,199.7214,1563655,-0.6500000000000057,0.6500000000000057,0.0,64.21668161489035,190.18,201.77,75.84124245038818,-24.158757549611824,2.1145476087127406,1.948212358284539,0.014945929402162772,-2733039,-1.0
614,COST,1527051600000,198.14,199.09,196.771,199.09,1635092,-0.8300000000000125,0.8300000000000125,0.0,57.24750055393915,191.28,201.77,65.39561487130581,-34.60438512869419,2.0198156838876855,1.9625330234051686,0.013763110770017795,-4368131,-1.0
615,COST,1527138000000,198.89,199.09,196.82,198.29,1176296,0.75,0.0,0.75,61.593320483742424,192.21,201.77,69.87447698744745,-30.125523012552545,1.9823962357421863,1.9665056658725724,0.01598896608091538,-3191835,1.0
616,COST,1527224400000,198.36,200.22,197.82,198.89,1330952,-0.5299999999999727,0.5299999999999727,0.0,56.878944067890934,192.42,201.77,63.52941176470601,-36.470588235293995,1.888214442931826,1.9508474212844233,0.01266081274249542,-4522787,-1.0
617,COST,1527570000000,196.74,198.84,196.0,198.1,2298069,-1.6200000000000045,1.6200000000000045,0.0,44.788457136756236,193.15,201.77,41.64733178654294,-58.35266821345706,1.6636946151399457,1.8934168600555281,0.006445672191528695,-6820856,-1.0
618,COST,1527656400000,199.64,200.53,197.75,198.16,2390862,2.8999999999999773,0.0,2.8999999999999773,61.6335867527662,193.26,201.77,74.97062279670953,-25.02937720329047,1.7001374230882504,1.8547609726620726,0.004680187207488196,-4429994,1.0
619,COST,1527742800000,198.24,200.6972,197.7,200.22,4822787,-1.3999999999999773,1.3999999999999773,0.0,52.68050856963338,193.26,201.77,58.519388954171646,-41.48061104582836,1.5976471102302696,1.8033382001757121,-0.006813627254508958,-9252781,-1.0
620,COST,1527829200000,197.13,198.99,195.0,195.45,4056435,-1.1100000000000136,1.1100000000000136,0.0,46.5009229034505,193.26,201.77,45.47591069330195,-54.52408930669805,1.410604502617673,1.7247914606641046,-0.009197828709288314,-13309216,-1.0
621,COST,1528088400000,198.62,199.04,197.2501,197.32,1870566,1.490000000000009,0.0,1.490000000000009,54.7264725523707,193.26,201.77,62.98472385428909,-37.015276145710914,1.3668336514200803,1.6531998988152998,-0.005009518084360232,-11438650,1.0
622,COST,1528174800000,197.84,199.35,196.99,199.22,1868462,-0.7800000000000011,0.7800000000000011,0.0,50.07592725530936,195.0,201.77,41.94977843426882,-58.05022156573118,1.254747457251284,1.573509410502497,-0.005679248127858472,-13307112,-1.0
623,COST,1528261200000,197.66,198.4,196.7,198.01,2066880,-0.18000000000000682,0.18000000000000682,0.0,48.96791679513823,195.0,201.77,39.290989660265765,-60.70901033973423,1.1382737409770982,1.4864622765974174,-0.002422529524578554,-15373992,-1.0
624,COST,1528347600000,202.57,202.88,199.41,200.5,2734952,4.909999999999997,0.0,4.909999999999997,69.91779267672119,195.0,202.88,96.0659898477157,-3.934010152284295,1.4256956115426647,1.474308943586467,0.01850268992910653,-12639040,1.0
625,COST,1528434000000,203.76,204.0139,201.0,201.51,2052538,1.1899999999999977,0.0,1.1899999999999977,73.01566332531752,195.0,204.0139,97.18323921942759,-2.8167607805724004,1.7295574133994194,1.5253586375490575,0.027223230490017958,-10586502,1.0
626,COST,1528693200000,204.5,204.89,203.42,203.76,1684839,0.7400000000000091,0.0,0.7400000000000091,74.87234800384714,195.0,204.89,96.05662285136515,-3.9433771486348523,2.0069423612780497,1.621675382294856,0.03944291958930557,-8901663,1.0
627,COST,1528779600000,204.88,205.08,203.23,204.25,1384769,0.37999999999999545,0.0,0.37999999999999545,75.85663988462694,195.0,205.08,98.01587301587284,-1.984126984127151,2.2317065480436327,1.7436816154446115,0.026247245041074008,-7516894,1.0
628,COST,1528866000000,204.11,205.83,203.21,204.92,1665822,-0.7699999999999818,0.7699999999999818,0.0,69.49216104683953,195.0,205.83,84.11819021237307,-15.881809787626933,2.320950179782443,1.8591353283121779,0.029610573042776478,-9182716,-1.0
629,COST,1528952400000,205.12,205.73,204.29,204.87,1685010,1.009999999999991,0.0,1.009999999999991,72.92965253131463,195.0,205.83,93.44413665743299,-6.55586334256701,2.444985733389103,1.9763054093275632,0.040531628874346914,-7497706,1.0
630,COST,1529038800000,207.32,207.67,204.57,205.4,3879641,2.1999999999999886,0.0,2.1999999999999886,78.90388249200385,195.0,207.67,97.23756906077352,-2.762430939226477,2.689790494710593,2.1190024264041694,0.043802235424428515,-3618065,1.0
631,COST,1529298000000,206.21,208.11,205.15,206.0,1975036,-1.1099999999999852,1.1099999999999852,0.0,69.92048269971309,195.0,208.11,85.50724637681157,-14.492753623188435,2.7623931710241436,2.247680575328164,0.04230691467852821,-5593101,-1.0
632,COST,1529384400000,207.53,207.81,204.622,204.9,1940614,1.3199999999999932,0.0,1.3199999999999932,73.98464441036904,195.0,208.11,95.57589626239503,-4.424103737604972,2.8930894540752377,2.376762351077579,0.04993423049681267,-3652487,1.0
633,COST,1529470800000,207.98,208.585,206.96,207.76,1527724,0.44999999999998863,0.0,0.44999999999998863,75.29753030328303,195.0,208.585,95.5465587044533,-4.45344129554669,2.9984127949129515,2.5010924398446535,0.02670681739645553,-2124763,1.0
634,COST,1529557200000,209.96,211.11,208.0,208.17,1825824,1.9800000000000182,0.0,1.9800000000000182,80.33573230756751,196.7,211.11,92.01943095072863,-7.980569049271365,3.2047034600425093,2.6418146438842247,0.03042795445622315,-298939,1.0
635,COST,1529643600000,211.1,211.77,210.02,210.37,1738640,1.1399999999999864,0.0,1.1399999999999864,82.68220432878203,196.7,211.77,95.55408095554071,-4.4459190444592895,3.4207429736116524,2.7976003098297104,0.032273838630806795,1439701,1.0
636,COST,1529902800000,211.75,212.08,209.97,210.01,2398551,0.6500000000000057,0.0,0.6500000000000057,83.94276775758244,196.7,212.08,97.85435630689199,-2.1456436931080103,3.6028717147810596,2.9586545908199806,0.03353182350644279,3838252,1.0
637,COST,1529989200000,210.09,212.46,209.97,212.38,2276654,-1.6599999999999966,1.6599999999999966,0.0,69.1174942208517,199.41,212.46,81.8390804597701,-18.1609195402299,3.572088972815351,3.081341467219055,0.029297927588065154,1561598,-1.0
638,COST,1530075600000,210.03,212.42,209.61,210.5,2211658,-0.060000000000002274,0.060000000000002274,0.0,68.61212201768997,201.0,212.46,78.79581151832457,-21.204188481675438,3.5024775046561274,3.16556867470647,0.023937207488299528,-650060,-1.0
639,COST,1530162000000,208.71,211.185,208.05,210.0,1826827,-1.3199999999999932,1.3199999999999932,0.0,57.87088963952155,203.21,212.46,59.45945945945946,-40.54054054054054,3.3027278166861436,3.193000503102405,0.006704611229018109,-2476887,-1.0
640,COST,1530248400000,208.98,210.53,208.32,209.66,2164570,0.2699999999999818,0.0,0.2699999999999818,59.37201274015878,203.21,212.46,62.37837837837819,-37.62162162162182,3.130128683659592,3.180426139213843,0.013432908200378124,-312317,1.0
641,COST,1530507600000,207.99,208.8244,206.0475,208.42,1876070,-0.9899999999999807,0.9899999999999807,0.0,51.59425046563654,203.21,212.46,51.67567567567569,-48.324324324324316,2.8802577996309537,3.1203924712972655,0.0022165470052522007,-2188387,-1.0
642,COST,1530594000000,207.12,209.91,206.9,208.53,842101,-0.8700000000000045,0.8700000000000045,0.0,45.544458994355224,204.29,212.46,34.638922888616975,-65.36107711138303,2.582266250603311,3.012767227158475,-0.004135012982017461,-3030488,-1.0
643,COST,1530766800000,209.14,209.29,207.55,208.2,1436725,2.019999999999982,0.0,2.019999999999982,58.56174803240286,204.57,212.46,57.921419518377505,-42.0785804816225,2.480505988619683,2.906314979450717,-0.0039055058106306495,-1593763,1.0
644,COST,1530853200000,209.62,210.39,206.6583,207.14,1523193,0.4800000000000182,0.0,0.4800000000000182,61.11061583691197,204.622,212.46,63.76626690482259,-36.23373309517741,2.41080125828654,2.807212235217882,-0.00701089531027943,-70570,1.0
645,COST,1531112400000,210.94,211.79,210.0,210.52,1738347,1.3199999999999932,0.0,1.3199999999999932,67.46137547323877,204.622,212.46,80.60729778004578,-19.392702219954217,2.43401309983318,2.7325724081409417,-0.0038252656434474286,1667777,1.0
646,COST,1531198800000,211.7,212.7,210.83,210.99,1687801,0.7599999999999909,0.0,0.7599999999999909,70.64594199949406,206.0475,212.7,84.96805712138288,-15.03194287861712,2.485086746590497,2.683075275830853,0.007663382359941018,3355578,1.0
647,COST,1531285200000,210.95,211.7758,209.97,211.21,1472787,-0.75,0.75,0.0,63.56245096696302,206.0475,212.7,73.69409996242004,-26.305900037579953,2.436953356375909,2.6338508919398644,0.004380326620006647,1882791,-1.0
648,COST,1531371600000,214.02,214.17,212.22,212.54,2221975,3.0700000000000216,0.0,3.0700000000000216,75.27262156910282,206.0475,214.17,98.15327793167155,-1.8467220683284424,2.6163674554143768,2.630354204634767,0.02544200086244075,4104766,1.0
649,COST,1531458000000,216.54,216.64,213.71,214.0,1951183,2.519999999999982,0.0,2.519999999999982,81.04289255693458,206.0475,216.64,99.0559358036347,-0.9440641963653016,2.9281410014125413,2.689911563990322,0.036175710594315236,6055949,1.0
650,COST,1531717200000,214.85,217.13,213.9,216.64,2078572,-1.6899999999999977,1.6899999999999977,0.0,68.64709758383188,206.0475,217.13,79.42702458831486,-20.57297541168513,3.0042255122721997,2.7527743536466978,0.03298235492090962,3977377,-1.0
651,COST,1531803600000,215.0,216.155,214.0,214.06,2064776,0.15000000000000568,0.0,0.15000000000000568,69.13064543900747,206.0475,217.13,80.78050981276789,-19.219490187232115,3.041565315434781,2.8105325460043145,0.03804557744302817,6042153,1.0
652,COST,1531890000000,214.97,215.88,213.6,215.34,1869527,-0.030000000000001137,0.030000000000001137,0.0,68.88547546933711,206.0475,217.13,80.50981276787729,-19.490187232122715,3.033765236196132,2.8551790840426783,0.02787606388065411,4172626,-1.0
653,COST,1531976400000,217.54,218.2,214.03,214.46,2790767,2.569999999999993,0.0,2.569999999999993,76.96167909568054,206.0475,218.2,94.5690187204279,-5.430981279572087,3.1980935896099254,2.923761985156128,0.03778265432687711,6963393,1.0
654,COST,1532062800000,218.69,218.93900000000002,216.24,216.98,1797886,1.1500000000000057,0.0,1.1500000000000057,79.68430736139565,206.0475,218.93900000000002,98.06849474459898,-1.9315052554010277,3.382132427766237,3.01543607367815,0.03674030530008543,8761279,1.0
655,COST,1532322000000,218.84,220.46,218.2,219.88,1394347,0.15000000000000568,0.0,0.15000000000000568,80.0393283280566,206.6583,220.46,88.26231551185721,-11.737684488142788,3.4997452376142064,3.1122979064653618,0.033726972130373234,10155626,1.0
656,COST,1532408400000,218.58,220.68,217.59,219.41,1453974,-0.2599999999999909,0.2599999999999909,0.0,77.33638925910651,206.6583,220.68,85.02321401827173,-14.97678598172827,3.5312682417362,3.19609197351953,0.03616970846172096,8701652,-1.0
657,COST,1532494800000,220.7,220.82,217.37,217.61,1562432,2.119999999999976,0.0,2.119999999999976,82.80087782428382,206.6583,220.82,99.15264410346212,-0.8473558965378775,3.6848390237531703,3.2938413835662583,0.031212036258293496,10264084,1.0
658,COST,1532581200000,221.72,224.62,220.82,222.0,1820005,1.0200000000000102,0.0,1.0200000000000102,84.83127794399755,209.97,224.62,80.20477815699655,-19.795221843003443,3.8445325164044846,3.403979610133904,0.02392167728826089,12084089,1.0
659,COST,1532667600000,219.65,222.5,218.76,222.31,1596914,-2.069999999999993,2.069999999999993,0.0,66.45952282477356,209.97,224.62,66.0750853242321,-33.924914675767894,3.7607088459534452,3.475325457297812,0.02234116825692345,10487175,-1.0
660,COST,1532926800000,219.11,220.118,218.61,219.04,1292741,-0.539999999999992,0.539999999999992,0.0,62.39230888812273,209.97,224.62,62.38907849829359,-37.61092150170641,3.609101220149199,3.5020806098680892,0.019116279069767428,9194434,-1.0
661,COST,1533013200000,218.71,220.065,218.33,219.69,1888516,-0.4000000000000057,0.4000000000000057,0.0,59.29101568986773,212.22,224.62,52.3387096774194,-47.6612903225806,3.4172822562785825,3.485120939150188,0.01739777643392104,7305918,-1.0
662,COST,1533099600000,217.13,219.0989,216.25099999999998,218.65,1841316,-1.5800000000000125,1.5800000000000125,0.0,48.33981463464772,213.6,224.62,32.032667876588,-67.96733212341199,3.102014017410198,3.408499554802191,-0.0018847108577733085,5464602,-1.0
663,COST,1533186000000,221.12,221.403,215.01,215.01,1904858,3.990000000000009,0.0,3.990000000000009,66.41497755677966,213.6,224.62,68.23956442831219,-31.76043557168781,3.1379476606525145,3.3543891759722553,0.011111619186977117,7369460,1.0
664,COST,1533272400000,222.03,222.62,221.0,221.0,1195653,0.9099999999999966,0.0,0.9099999999999966,69.24660271598776,213.6,224.62,76.49727767695099,-23.50272232304901,3.20293300109887,3.324097940997578,0.01457685980625123,8565113,1.0
665,COST,1533531600000,222.72,223.27,221.0112,221.43,1285660,0.6899999999999977,0.0,0.6899999999999977,71.3592641142656,213.6,224.62,82.75862068965513,-17.24137931034486,3.2723892953042935,3.313756211858921,0.018940433708481974,9850773,1.0
666,COST,1533618000000,223.86,225.48,222.98,223.24,1428145,1.1400000000000148,0.0,1.1400000000000148,74.67574260401015,214.03,225.48,85.85152838427967,-14.148471615720329,3.380454281634286,3.3270958258139944,0.014318078840054538,11278918,1.0
667,COST,1533704400000,224.58,224.88,222.24,222.86,2015845,0.7199999999999989,0.0,0.7199999999999989,76.6464471768677,215.01,225.48,91.40401146131826,-8.595988538681732,3.484032584753237,3.358483177601843,0.012899152083709176,13294763,1.0
668,COST,1533790800000,218.24,222.35,216.9101,221.62,3637144,-6.340000000000003,6.340000000000003,0.0,42.803474772495996,215.01,225.48,30.85004775549206,-69.14995224450794,3.0197260297219373,3.290731748025862,-0.006419303437286583,9657619,-1.0
669,COST,1533877200000,220.31,221.7202,217.75,218.14,2830841,2.069999999999993,0.0,2.069999999999993,50.96081714319169,215.01,225.48,50.62082139446048,-49.37917860553952,2.786668024546799,3.18991900333005,0.005476701200310297,12488460,1.0
670,COST,1534136400000,219.56,221.58,219.06,221.03,1519026,-0.75,0.75,0.0,48.09332227970373,215.01,225.48,43.457497612225524,-56.54250238777448,2.5124868996835232,3.0544325826007452,0.0038864249462757794,10969434,-1.0
671,COST,1534222800000,222.0,222.56,219.86,220.01,1450552,2.4399999999999977,0.0,2.4399999999999977,57.14526073114897,215.01,225.48,66.76217765042989,-33.23782234957011,2.463683730770015,2.9362828122345994,0.022428959609450683,12419986,1.0
672,COST,1534309200000,221.67,222.11,218.77,220.72,1844066,-0.3300000000000125,0.3300000000000125,0.0,55.631317043419436,215.01,225.48,63.61031518624639,-36.38968481375361,2.3710467219638645,2.823235594180453,0.0024873371924745147,10575920,-1.0
673,COST,1534395600000,223.19,224.26,222.14,223.45,1657827,1.5200000000000102,0.0,1.5200000000000102,61.10744439131385,215.01,225.48,78.12798471824267,-21.872015281757328,2.3927007138819363,2.73712861812075,0.005224519209115819,12233747,1.0
674,COST,1534482000000,225.68,225.88,222.15,222.33,1980933,2.490000000000009,0.0,2.490000000000009,68.46444986813349,215.01,225.88,98.16007359705623,-1.839926402943777,2.5810309627055688,2.705909087037714,0.013290229885057459,14214680,1.0
675,COST,1534741200000,227.35,228.22,225.97,226.0,1783663,1.6699999999999875,0.0,1.6699999999999875,72.49133420675855,215.01,228.22,93.41408024224069,-6.585919757759304,2.83238883523714,2.7312050366775993,0.015590100955954478,15998343,1.0
676,COST,1534827600000,228.54,230.1,227.7,229.49,2066671,1.1899999999999977,0.0,1.1899999999999977,75.10505020448845,215.01,230.1,89.66202783300197,-10.337972166998025,3.091972323315531,2.803358494005186,0.017632914774245112,18065014,1.0
677,COST,1534914000000,229.21,230.23,228.3819,228.48,1268080,0.6700000000000159,0.0,0.6700000000000159,76.55236707242238,216.9101,230.23,92.34228485198851,-7.657715148011492,3.313560753849117,2.9053989459739724,0.05026576246334313,19333094,1.0
678,COST,1535000400000,229.51,230.35,228.57,229.0,1338164,0.29999999999998295,0.0,0.29999999999998295,77.23611054846174,216.9101,230.35,93.74995349667778,-6.250046503322225,3.4733401283699834,3.018987182453175,0.04175933911306795,20671258,1.0
679,COST,1535086800000,231.28,232.06,229.6,230.0,1453290,1.7700000000000102,0.0,1.7700000000000102,81.00659342068462,216.9101,232.06,94.85145116469414,-5.14854883530585,3.700137574861401,3.1552172609348204,0.05337948624521771,22124548,1.0
680,COST,1535346000000,230.03,232.86,228.1,232.74,1904071,-1.25,1.25,0.0,71.3733753147933,216.9101,232.86,82.25694204979335,-17.743057950206648,3.7359460742467547,3.2713630235972073,0.03617117117117119,20220477,-1.0
681,COST,1535432400000,230.26,231.83,229.84,230.94,1882143,0.22999999999998977,0.0,0.22999999999998977,72.07832515942066,216.9101,232.86,83.6989573602341,-16.301042639765896,3.7397738339023476,3.365045185658236,0.03875129697297797,22102620,1.0
682,COST,1535518800000,230.19,232.0,228.7345,231.79,1793792,-0.06999999999999318,0.06999999999999318,0.0,71.4603495676088,217.75,232.86,82.32958305757766,-17.670416942422325,3.6945702387264703,3.4309501962718834,0.03136341233926254,20308828,-1.0
683,COST,1535605200000,230.83,231.16,229.44,229.62,1272010,0.6400000000000148,0.0,0.6400000000000148,73.82757910928805,218.77,232.86,85.59261887863732,-14.407381121362672,3.6681050316988717,3.4783811633572808,0.022819922013470384,21580838,1.0
684,COST,1535691600000,233.13,233.52,230.21,230.21,1881346,2.299999999999983,0.0,2.299999999999983,80.52565829360844,218.77,233.52,97.35593220338973,-2.64406779661027,3.7890440422515326,3.540513739136131,0.02542335605893986,23462184,1.0
685,COST,1536037200000,234.68,234.91,233.14,233.14,1858396,1.5500000000000114,0.0,1.5500000000000114,83.75787827992337,218.77,234.91,98.57496902106574,-1.4250309789342626,3.964263461696305,3.6252636836481664,0.026866194101689,25320580,1.0
686,COST,1536123600000,235.61,236.17,233.2,234.57,2126027,0.9300000000000068,0.0,0.9300000000000068,85.43182777076547,222.14,236.17,96.00855310049911,-3.9914468995008825,4.130554817050495,3.7263219103286325,0.02792199293224562,27446607,1.0
687,COST,1536210000000,236.68,236.77,235.06,235.47,1853243,1.0699999999999932,0.0,1.0699999999999932,87.1851504004255,222.15,236.77,99.38440492476059,-0.6155950752394213,4.299124280282058,3.8408823843193174,0.031240468824887957,29299850,1.0
688,COST,1536296400000,241.46,242.95,237.2,237.31,2722823,4.780000000000001,0.0,4.780000000000001,92.09139141365029,225.97,242.95,91.22497055359257,-8.77502944640743,4.763511806551747,4.025408268765804,0.044015911449325484,32022673,1.0
689,COST,1536555600000,243.18,243.8042,242.115,243.0,2817471,1.7199999999999989,0.0,1.7199999999999989,93.17610732310804,227.7,243.8042,96.12399249885122,-3.8760075011487753,5.210271044907699,4.262380823994183,0.05716645654914587,34840144,1.0
690,COST,1536642000000,244.21,245.16,243.17,243.93,2185657,1.0300000000000011,0.0,1.0300000000000011,93.76682744219912,228.1,245.16,94.43141852286055,-5.56858147713944,5.5830849728477006,4.526521653764887,0.060583688004864245,37025801,1.0
691,COST,1536728400000,242.44,245.12,242.23,245.0,1912116,-1.7700000000000102,1.7700000000000102,0.0,80.030002774388,228.1,245.16,84.05627198124267,-15.94372801875732,5.670354237333669,4.755288170478644,0.05321690777184074,35113685,-1.0
692,COST,1536814800000,241.27,243.99,241.05,242.5,2078161,-1.1699999999999875,1.1699999999999875,0.0,71.98644206250175,228.1,245.16,77.19812426729199,-22.80187573270801,5.580774874504868,4.9203855112838895,0.04522808993631666,33035524,-1.0
693,COST,1536901200000,235.38,239.0,234.47,239.0,3875326,-5.890000000000015,5.890000000000015,0.0,45.451387015839636,228.1,245.16,42.672919109026964,-57.327080890973036,4.977135679842007,4.931735544995513,0.009651267533135943,29160198,-1.0
694,COST,1537160400000,232.0,234.585,231.51,234.06,2884630,-3.3799999999999955,3.3799999999999955,0.0,36.53435971015999,228.7345,245.16,19.880673343277238,-80.11932665672276,4.177849966558739,4.780958429308159,-0.011419805692858387,26275568,-1.0
695,COST,1537246800000,234.35,235.47,231.7,231.98,2000248,2.3499999999999943,0.0,2.3499999999999943,45.16477431346312,228.7345,245.16,34.18769596054913,-65.81230403945086,3.6914824613173494,4.563063235709997,-0.0053478205509104315,28275816,1.0
696,COST,1537333200000,233.85,234.74,232.4217,234.62,1581403,-0.5,0.5,0.0,43.705687935046996,229.44,245.16,28.0534351145038,-71.9465648854962,3.2284710955040623,4.29614480766881,-0.01195707284096681,26694413,-1.0
697,COST,1537419600000,233.92,234.99599999999998,232.32,234.6,1910100,0.06999999999999318,0.0,0.06999999999999318,43.99794235320863,230.21,245.16,24.81605351170557,-75.18394648829442,2.834505253016971,4.003816896738442,-0.031226704216019252,28604513,1.0
698,COST,1537506000000,234.76,235.84,234.01,234.37,3718002,0.8400000000000034,0.0,0.8400000000000034,47.7535685064275,231.51,245.16,23.8095238095238,-76.1904761904762,2.5605490295114066,3.715163323293035,-0.03462455794062014,32322515,1.0
699,COST,1537765200000,233.34,234.85,232.9,234.19,1530454,-1.4199999999999875,1.4199999999999875,0.0,42.229587521451094,231.51,245.16,13.406593406593492,-86.59340659340651,2.203454592527521,3.4128215771399324,-0.044510871790672035,30792061,-1.0
700,COST,1537851600000,232.93,234.66,232.73,234.03,1889791,-0.4099999999999966,0.4099999999999966,0.0,40.66253270449455,231.51,245.16,10.402930402930515,-89.59706959706949,1.8658626101818925,3.1034297837483242,-0.03922620029698065,28902270,-1.0
701,COST,1537938000000,233.81,235.66,233.45,233.57,2008481,0.8799999999999955,0.0,0.8799999999999955,45.65666832683566,231.51,245.16,16.849816849816925,-83.15018315018308,1.6503034902325737,2.8128045250451743,-0.030919716500186545,30910751,1.0
702,COST,1538024400000,234.0,235.67,232.34,233.7,1421368,0.18999999999999773,0.0,0.18999999999999773,46.77272033452743,231.51,245.16,18.2417582417583,-81.7582417582417,1.4777679542998783,2.545797210896115,-0.0058628600560795,32332119,1.0
703,COST,1538110800000,234.88,235.47,233.79,233.86,1602808,0.8799999999999955,0.0,0.8799999999999955,52.03680926040979,231.51,245.16,24.68864468864471,-75.31135531135529,1.3959492961996318,2.3158276279568186,0.012413793103448256,33934927,1.0
704,COST,1538370000000,234.65,236.53,234.43,235.81,1673068,-0.22999999999998977,0.22999999999998977,0.0,50.529753920432725,231.51,245.12,23.071271124173485,-76.92872887582651,1.29759052945397,2.112180208256249,0.0012801365478984916,32261859,-1.0
705,COST,1538456400000,236.35,237.57,233.87,234.1,1647638,1.6999999999999886,0.0,1.6999999999999886,60.32842131513071,231.51,243.99,38.782051282051256,-61.217948717948744,1.341353974225484,1.9580149614500961,0.010690613641223035,33909497,1.0
706,COST,1538542800000,233.2,237.31,232.73,236.62,2322277,-3.1500000000000057,3.1500000000000057,0.0,42.3809527764644,231.51,239.0,22.563417890520636,-77.43658210947937,1.1090734747776878,1.7882266641156146,-0.0030779753761970285,31587220,-1.0
707,COST,1538629200000,231.68,234.0,230.66,233.26,2862779,-1.5199999999999818,1.5199999999999818,0.0,36.35856263193024,230.66,237.57,14.761215629522587,-85.23878437047742,0.7931947704223319,1.5892202853769581,-0.013119781904924133,28724441,-1.0
708,COST,1538715600000,218.82,227.06,217.79,225.0,7379026,-12.860000000000014,12.860000000000014,0.0,15.230541909981923,217.79,237.57,5.207280080889793,-94.7927199191102,-0.48919661325942343,1.1735369056496818,-0.06222679352018523,21345415,-1.0
709,COST,1538974800000,223.93,224.4999,219.2569,219.34,3863457,5.110000000000014,0.0,5.110000000000014,33.064134142219146,217.79,237.57,31.04145601617803,-68.95854398382197,-1.0807090370959997,0.7226877171005455,-0.03863821749023311,25208872,1.0
710,COST,1539061200000,224.17,225.15,222.56,224.15,2502767,0.23999999999998067,0.0,0.23999999999998067,33.81865845780155,217.79,237.57,32.25480283114254,-67.74519716885746,-1.5126836263910661,0.27561344840222307,-0.041230058594585395,27711639,1.0
711,COST,1539147600000,221.05,225.0,221.04,224.1,3021443,-3.119999999999976,3.119999999999976,0.0,28.927453923415626,217.79,237.57,16.481294236602725,-83.51870576339728,-2.0827755586718695,-0.1960643530125956,-0.055341880341880256,24690196,-1.0
712,COST,1539234000000,221.82,225.32,220.93,222.91,3650928,0.7699999999999818,0.0,0.7699999999999818,31.73881923866307,217.79,237.57,20.374115267947428,-79.62588473205258,-2.444268951507837,-0.645705272711644,-0.055602861035422335,28341124,1.0
713,COST,1539320400000,226.95,227.62,223.39,225.2,3130467,5.1299999999999955,0.0,5.1299999999999955,47.65573903584732,217.79,237.57,46.30940343781595,-53.69059656218405,-2.290404620266372,-0.9746451422225899,-0.03281483059876422,31471591,1.0
714,COST,1539579600000,224.51,226.94,224.25,226.25,2441901,-2.4399999999999977,2.4399999999999977,0.0,42.24914761418459,217.79,237.57,33.97371081900909,-66.0262891809909,-2.338398024047649,-1.247395718587602,-0.05009519779987304,29029690,-1.0
715,COST,1539666000000,227.68,228.26,224.31599999999997,224.87,2541811,3.170000000000016,0.0,3.170000000000016,50.64321659108544,217.79,237.57,50.000000000000064,-49.99999999999993,-2.096473809170675,-1.4172113367042167,-0.023670668953687746,31571501,1.0
716,COST,1539752400000,228.49,228.88,225.51,228.45,2129262,0.8100000000000023,0.0,0.8100000000000023,52.671418945693475,217.79,237.57,54.09504550050565,-45.90495449949435,-1.818425225800894,-1.4974541145235523,-0.01376899171270718,33700763,1.0
717,COST,1539838800000,228.58,230.65,226.25,228.54,2624596,0.09000000000000341,0.0,0.09000000000000341,52.91945301066994,217.79,237.57,54.55005055611739,-45.44994944388261,-1.572678612759404,-1.5124990141707229,0.04460286993876261,36325359,1.0
718,COST,1539925200000,229.67,230.63,228.72,228.9,2099838,1.089999999999975,0.0,1.089999999999975,56.132124672342144,217.79,237.57,60.06066734074821,-39.9393326592518,-1.275268267460433,-1.4650528648286651,0.025633010315723626,38425197,1.0
719,COST,1540184400000,229.06,230.25,227.27,229.88,2007324,-0.6099999999999852,0.6099999999999852,0.0,53.763148040235265,217.79,237.31,57.73565573770494,-42.26434426229506,-1.0763824584275028,-1.3873187835484329,0.02181380202524874,36417873,-1.0
720,COST,1540270800000,228.75,229.26,223.82,227.07,2656674,-0.3100000000000023,0.3100000000000023,0.0,52.46478262366578,217.79,234.0,67.61258482418262,-32.38741517581738,-0.933023120058948,-1.296459650850536,0.03483374802080963,33761199,-1.0
721,COST,1540357200000,223.76,231.09,223.09,225.93,3100203,-4.990000000000009,4.990000000000009,0.0,36.21913364819756,217.79,231.09,44.88721804511274,-55.11278195488727,-1.208134466937338,-1.2787946140678965,0.008745829952213402,30660996,-1.0
722,COST,1540443600000,226.4,227.59,222.84,224.06,2218870,2.640000000000015,0.0,2.640000000000015,46.35870762264268,219.2569,231.09,60.365415656083385,-39.634584343916615,-1.199311349363768,-1.262897961127071,-0.0024234412866269706,32879866,1.0
723,COST,1540530000000,218.19,225.0,217.0,222.31,3995362,-8.210000000000008,8.210000000000008,0.0,29.51940676230322,217.0,231.09,8.44570617459189,-91.55429382540811,-1.8336600324822427,-1.3770503753981054,-0.028150193755289266,28884504,-1.0
724,COST,1540789200000,222.42,224.89,218.75,219.75,3801401,4.22999999999999,0.0,4.22999999999999,42.03623849473086,217.0,231.09,38.466997870830276,-61.533002129169724,-1.9723245684091353,-1.4961052140003115,-0.023102600140548213,32685905,1.0
725,COST,1540875600000,227.92,228.21,223.0104,223.1,2410593,5.5,0.0,5.5,54.23084932939874,217.0,231.09,77.50177430801976,-22.498225691980238,-1.6197418176373048,-1.5208325347277103,-0.0024946387150422966,35096498,1.0
726,COST,1540962000000,228.63,230.56,225.56,228.65,2674561,0.710000000000008,0.0,0.710000000000008,55.62152955724855,217.0,231.09,82.54080908445701,-17.45919091554299,-1.2684049997562283,-1.470347027733414,0.00021874179718262,37771059,1.0
727,COST,1541048400000,229.6,230.8,227.54,228.18,2095039,0.9699999999999989,0.0,0.9699999999999989,57.65000200465538,217.0,231.09,89.42512420156133,-10.57487579843867,-0.9013074382710045,-1.3565391098409323,-0.0003047851264857959,39866098,1.0
728,COST,1541134800000,230.16,232.23,227.1787,229.81,2167198,0.5600000000000023,0.0,0.5600000000000023,58.90137918477571,217.0,232.23,86.408404464872,-13.591595535128,-0.5587517154740453,-1.196981630967555,0.00480223522221257,42033296,1.0
729,COST,1541397600000,234.45,234.89,229.8,230.71,2513883,4.289999999999992,0.0,4.289999999999992,67.41275325355312,217.0,234.89,97.54052543320292,-2.4594745667970828,0.05822215202499592,-0.9459408743690447,0.024918032786885203,44547179,1.0
730,COST,1541484000000,236.71,237.49,234.1757,235.0,2101471,2.2600000000000193,0.0,2.2600000000000193,71.05630883542875,217.0,237.49,96.19326500732063,-3.806734992679359,0.7212276317397937,-0.612507173147277,0.05787450840185926,46648650,1.0
731,COST,1541570400000,240.37,240.88,236.935,238.75,2603891,3.6599999999999966,0.0,3.6599999999999966,76.05839858020768,217.0,240.88,97.86432160804024,-2.1356783919597615,1.5244230563885992,-0.18512112724010163,0.06170494699646634,49252541,1.0
732,COST,1541656800000,238.7,239.8,237.03,238.51,2140624,-1.670000000000016,1.670000000000016,0.0,69.71519964792553,217.0,240.88,90.87102177554436,-9.128978224455642,2.0031155077735434,0.2525261997626275,0.09400064164260513,47111917,-1.0
733,COST,1541743200000,237.74,240.26,237.07,237.97,2256718,-0.9599999999999795,0.9599999999999795,0.0,66.06086688364957,217.0,240.88,86.85092127303187,-13.149078726968119,2.2787507287270614,0.6577711055555144,0.06887869795881674,44855199,-1.0
734,COST,1542002400000,234.48,239.2,234.13,237.64,2301381,-3.2600000000000193,3.2600000000000193,0.0,54.80465330668548,217.0,240.88,73.19932998324956,-26.80067001675045,2.2086786045543363,0.9679526053552789,0.028782028782028846,42553818,-1.0
735,COST,1542088800000,234.14,236.42,232.77,234.75,1548087,-0.3400000000000034,0.3400000000000034,0.0,53.70346997714304,217.0,240.88,71.77554438860967,-28.224455611390326,2.1014861588861606,1.1946593160614556,0.0241000743559463,41005731,-1.0
736,COST,1542175200000,233.31,237.12,231.71,237.12,1896480,-0.8299999999999841,0.8299999999999841,0.0,50.826850135492094,217.0,240.88,68.29983249581242,-31.700167504187583,1.9273440880673718,1.341196270462639,0.016158536585365812,39109251,-1.0
737,COST,1542261600000,229.94,232.65,227.0,232.32,2722281,-3.3700000000000045,3.3700000000000045,0.0,40.63073900233243,218.75,240.88,50.56484410302756,-49.43515589697244,1.5001120524159433,1.3729794268533,-0.0009558567952728803,36386970,-1.0
738,COST,1542348000000,231.02,231.12,226.52,229.3,2822396,1.0800000000000125,0.0,1.0800000000000125,44.73058895239799,223.0104,240.88,44.82249182969966,-55.177508170300335,1.2344446495695252,1.3452724713965452,-0.014629985071443752,39209366,1.0
739,COST,1542607200000,228.74,233.5,227.81,231.61,1949496,-2.280000000000001,2.280000000000001,0.0,38.289681342461186,225.56,240.88,20.757180156658016,-79.24281984334198,0.8303525879966571,1.2422884947165675,-0.03366989142832999,37259870,-1.0
740,COST,1542693600000,219.31,225.0,218.05,224.92,3704770,-9.430000000000007,9.430000000000007,0.0,22.694555435274054,218.05,240.88,5.5190538764782815,-94.48094612352172,-0.24795716794750433,0.9442393621837532,-0.0876149269875609,33555100,-1.0
741,COST,1542780000000,218.57,222.03,217.45,220.56,2036736,-0.7400000000000091,0.7400000000000091,0.0,21.887378371446943,217.45,240.88,4.780196329492123,-95.21980367050787,-1.1489923644086275,0.5255930168652769,-0.08433179723502304,31518364,-1.0
742,COST,1542952800000,220.06,221.18,217.6596,218.1,1007476,1.490000000000009,0.0,1.490000000000009,27.849349130753367,217.45,240.88,11.139564660691475,-88.86043533930852,-1.7229772929817955,0.0758789548958623,-0.07436695549760242,32525840,1.0
743,COST,1543212000000,219.45,223.48,218.9,222.85,2205570,-0.6100000000000136,0.6100000000000136,0.0,26.880195721755868,217.45,240.88,8.536064874093041,-91.46393512590696,-2.2017064838840383,-0.379638132860118,-0.0640992835209826,30320270,-1.0
744,COST,1543298400000,223.01,223.12,218.38,219.37,2369826,3.5600000000000023,0.0,3.5600000000000023,40.76200047171964,217.45,240.88,23.730260349978664,-76.26973965002134,-2.2676999378785183,-0.7572504938637983,-0.047535662424190606,32690096,1.0
745,COST,1543384800000,230.34,230.46,222.19,222.78,2765564,7.3300000000000125,0.0,7.3300000000000125,59.17542210783591,217.45,240.26,56.51030249890405,-43.489697501095954,-1.7088321362781187,-0.9475668223466626,-0.012729844413012725,35455660,1.0
746,COST,1543471200000,231.0,231.59,228.36,229.0,1478742,0.6599999999999966,0.0,0.6599999999999966,60.45256731265666,217.45,240.26,59.4037702761947,-40.59622972380531,-1.1988493047983297,-0.997823318836996,0.004609898234321896,36934402,1.0
747,COST,1543557600000,231.28,233.39,229.7,231.69,2764157,0.28000000000000114,0.0,0.28000000000000114,61.049051066081226,217.45,239.2,63.58620689655178,-36.413793103448214,-0.7632918238341801,-0.9509170198364331,0.0011254436845293814,39698559,1.0
748,COST,1543816800000,232.08,232.2,228.21,230.72,2481489,0.8000000000000114,0.0,0.8000000000000114,62.8940808449076,217.45,237.12,74.37722419928832,-25.622775800711683,-0.3495269394483671,-0.8306390037588199,0.014601731223222947,42180048,1.0
749,COST,1543903200000,226.35,233.3,225.56,232.11,3418588,-5.730000000000018,5.730000000000018,0.0,45.1997567745047,217.45,237.12,45.24656837824097,-54.75343162175903,-0.4784629740638593,-0.7602037978198279,0.032100679403583854,38761460,-1.0
750,COST,1544076000000,233.2,233.86,226.6,227.94,4029790,6.849999999999994,0.0,6.849999999999994,60.52049666209925,217.45,233.86,95.97806215722106,-4.021937842778939,-0.02758992166369012,-0.6136810225886005,0.06693507800704568,42791250,1.0
751,COST,1544162400000,224.86,233.81,223.03,233.15,2881911,-8.339999999999975,8.339999999999975,0.0,43.45383017075268,217.45,233.86,45.15539305301653,-54.84460694698347,-0.33932653077062014,-0.5588101242250044,0.021812233027356243,39909339,-1.0
752,COST,1544421600000,222.66,225.2,219.11,224.54,2649984,-2.200000000000017,2.200000000000017,0.0,40.01891464314205,217.45,233.86,31.74893357708714,-68.25106642291286,-0.7551962205232599,-0.5980873434846555,0.014627477785372545,37259355,-1.0
753,COST,1544508000000,226.5,227.25,224.0,225.12,2466780,3.8400000000000034,0.0,3.8400000000000034,48.25650528106775,217.45,233.86,55.149299207800105,-44.850700792199895,-0.7660890416961763,-0.6316876831269598,0.015649522442939823,39726135,1.0
754,COST,1544594400000,227.8,230.45,227.07,228.35,2891394,1.3000000000000114,0.0,1.3000000000000114,50.89105572659944,217.45,233.86,63.071297989031116,-36.92870201096888,-0.6621892405327117,-0.6377879946081102,-0.011027177216288875,42617529,1.0
755,COST,1544680800000,226.51,229.615,225.48,228.84,2170188,-1.2900000000000205,1.2900000000000205,0.0,48.08769498945307,217.6596,233.86,54.63074985802806,-45.36925014197194,-0.6761459288262017,-0.6454595814517285,-0.019437229437229475,40447341,-1.0
756,COST,1544767200000,207.06,219.0,205.51,218.0,8822269,-19.44999999999999,19.44999999999999,0.0,24.555453748390576,205.51,233.86,5.467372134038836,-94.53262786596116,-2.2309422359344353,-0.9625561123482701,-0.10472154963680391,31625072,-1.0
757,COST,1545026400000,202.23,207.995,200.66,206.68,4739434,-4.8300000000000125,4.8300000000000125,0.0,21.53574739995186,200.66,233.86,4.7289156626505795,-95.27108433734942,-3.808962791726941,-1.5318374482240045,-0.12861944157187188,26885638,-1.0
758,COST,1545112800000,202.99,204.6659,201.57,203.09,3308488,0.7600000000000193,0.0,0.7600000000000193,23.249361834888447,200.66,233.86,7.01807228915666,-92.98192771084334,-4.941269919113267,-2.2137239424018573,-0.10320300419703987,30194126,1.0
759,COST,1545199200000,201.41,207.0,199.86,203.5,3369592,-1.5800000000000125,1.5800000000000125,0.0,22.092003675441262,199.86,233.86,4.558823529411715,-95.44117647058829,-5.898134250229845,-2.9506060039674553,-0.13632075471698113,26824534,-1.0
760,COST,1545285600000,197.13,200.7,193.6753,200.33,4250942,-4.280000000000001,4.280000000000001,0.0,19.117453064704364,193.6753,233.86,8.59705310727715,-91.40294689272285,-6.92202357716053,-3.744889518606071,-0.1233211776216313,22573592,-1.0
761,COST,1545372000000,194.52,200.7,194.32,197.16,5080238,-2.609999999999985,2.609999999999985,0.0,17.46301634195123,193.6753,233.86,2.1020438126949235,-97.89795618730508,-7.853537737894612,-4.5666191624637795,-0.1263810293721368,17493354,-1.0
762,COST,1545631200000,189.99,195.3272,189.8,193.9,2031705,-4.530000000000001,4.530000000000001,0.0,14.883537873405373,189.8,233.86,0.4312301407171986,-99.5687698592828,-8.855225039813035,-5.424340337933631,-0.1611920529801324,15461649,-1.0
763,COST,1545804000000,198.63,198.78,189.51,190.82,3268831,8.639999999999986,0.0,8.639999999999986,35.76452529671769,189.51,233.86,20.563697857948142,-79.43630214205186,-8.849877770038177,-6.109447824354541,-0.12805092186128186,18730480,1.0
764,COST,1545890400000,201.08,201.13,193.96,196.96,2705884,2.450000000000017,0.0,2.450000000000017,40.537416052603646,189.51,233.81,26.11738148984203,-73.88261851015797,-8.549393410613789,-6.597436941606392,-0.11226877400556257,21436364,1.0
765,COST,1545976800000,202.04,204.95,199.59,201.82,2037917,0.9599999999999795,0.0,0.9599999999999795,42.47006724075856,189.51,230.45,30.60576453346361,-69.39423546653639,-8.139961010477606,-6.905941755380635,-0.024244180430793016,23474281,1.0
766,COST,1546236000000,203.71,204.39,201.38,203.38,1729647,1.670000000000016,0.0,1.670000000000016,45.99336969308115,189.51,230.45,34.68490473864196,-65.31509526135804,-7.59319817852662,-7.043393040009832,0.007318399841764522,25203928,1.0
767,COST,1546408800000,204.76,205.1,199.85,200.5,2143091,1.049999999999983,0.0,1.049999999999983,48.29081148394718,189.51,230.45,37.24963361016121,-62.75036638983879,-6.994529883757849,-7.033620408759435,0.008719641361643271,27347019,1.0
768,COST,1546495200000,200.42,205.935,200.04,203.7,2877745,-4.340000000000003,4.340000000000003,0.0,40.14589060285261,189.51,229.615,27.20359057474128,-72.79640942525872,-6.791988855962131,-6.985294098199975,-0.00491534680502459,24469274,-1.0
769,COST,1546581600000,206.24,207.93,201.45,203.08,2761611,5.820000000000022,0.0,5.820000000000022,52.53357318317875,189.51,219.0,56.73109528653786,-43.26890471346215,-6.091627779388148,-6.80656083443761,0.046213158829199186,27230885,1.0
770,COST,1546840800000,207.0,209.12,203.54,205.52,2226738,0.7599999999999909,0.0,0.7599999999999909,53.969012706133384,189.51,209.12,89.18918918918918,-10.810810810810827,-5.412864796044886,-6.527821626759066,0.06415792720542868,29457623,1.0
771,COST,1546927200000,208.55,209.08,204.18,208.65,2366493,1.5500000000000114,0.0,1.5500000000000114,57.02716019478927,189.51,209.12,97.09331973482921,-2.9066802651707944,-4.695738643451563,-6.1614050300975665,0.0976893520711617,31824116,1.0
772,COST,1547013600000,209.9,211.2182,207.92,209.15,1862926,1.3499999999999943,0.0,1.3499999999999943,59.716730061985174,189.51,211.2182,93.92764024654284,-6.072359753457173,-3.9726826705124836,-5.72366055818055,0.05673865981976545,33687042,1.0
773,COST,1547100000000,210.64,210.9,206.0,208.15,2340657,0.7399999999999807,0.0,0.7399999999999807,61.25063764470957,189.51,211.2182,97.33649035848201,-2.6635096415179955,-3.301881749651784,-5.239304796474798,0.047543266361647074,36027699,1.0
774,COST,1547186400000,210.51,211.25,209.31,210.04,1861225,-0.12999999999999545,0.12999999999999545,0.0,60.781494481977816,189.51,211.25,96.59613615455378,-3.4038638454462227,-2.7490675609393804,-4.741257349367714,0.04192239160562261,34166474,-1.0
775,COST,1547445600000,209.0,210.65,208.16,209.47,1523315,-1.509999999999991,1.509999999999991,0.0,55.12290278053876,189.51,211.25,89.65041398344067,-10.349586016559334,-2.405078466434162,-4.274021572781004,0.025968288252908422,32643159,-1.0
776,COST,1547532000000,211.03,211.34,209.08,210.04,1681846,2.030000000000001,0.0,2.030000000000001,60.78589869076228,189.51,211.34,98.57993586807146,-1.4200641319285483,-1.9462257176726325,-3.80846240175933,0.03062121508107052,34325005,1.0
777,COST,1547618400000,210.18,211.46,209.5,211.46,1455042,-0.8499999999999943,0.8499999999999943,0.0,57.29294042432526,193.96,211.46,92.68571428571428,-7.31428571428572,-1.6323527581420478,-3.3732404730358736,0.048697734757010336,32869963,-1.0
778,COST,1547704800000,211.46,211.65,209.65,209.87,1517058,1.2800000000000011,0.0,1.2800000000000011,61.16995472096891,199.59,211.65,98.42454394693203,-1.575456053067974,-1.2657303225807084,-2.9517384429448406,0.025310318076027905,34387021,1.0
779,COST,1547791200000,213.59,214.16,211.77,212.56,2115355,2.1299999999999955,0.0,2.1299999999999955,66.93365585992689,199.85,214.16,96.01677148846966,-3.9832285115303496,-0.7941517156393445,-2.5202210974837413,0.03183574879227047,36502376,1.0
780,COST,1548136800000,212.4,215.555,210.8,213.0,3310793,-1.1899999999999977,1.1899999999999977,0.0,61.08835030218442,199.85,215.555,79.91085641515441,-20.08914358484558,-0.5105599099757967,-2.1182888599821523,0.018460800767202024,33191583,-1.0
781,COST,1548223200000,212.09,214.845,210.0,213.0,2220161,-0.3100000000000023,0.3100000000000023,0.0,59.525812113485635,200.04,215.555,77.66677408959072,-22.333225910409283,-0.30728359601238253,-1.7560878071881982,0.010433539780847934,30971422,-1.0
782,COST,1548309600000,210.31,212.39,208.9,212.39,1994413,-1.7800000000000011,1.7800000000000011,0.0,50.90006374477335,201.45,215.555,62.814604750088634,-37.185395249911366,-0.28651402123844605,-1.4621730499982477,-0.001566654006836199,28977009,-1.0
783,COST,1548396000000,209.07,212.31900000000002,208.74,212.03,2252889,-1.240000000000009,1.240000000000009,0.0,45.589880599968104,203.54,215.555,46.02580108198081,-53.97419891801919,-0.36589382419589356,-1.242917204837777,-0.0068405301410858765,26724120,-1.0
784,COST,1548655200000,210.77,210.79,207.31,208.68,1999432,1.700000000000017,0.0,1.700000000000017,53.29728954632784,204.18,215.555,57.934065934065956,-42.06593406593404,-0.28830371175777714,-1.051994506221777,0.008468899521531181,28723552,1.0
785,COST,1548741600000,210.31,210.54,208.5668,210.32,1636487,-0.46000000000000796,0.46000000000000796,0.0,51.03995551964518,206.0,215.555,45.10727367870224,-54.89272632129776,-0.2609233819231065,-0.8937802813620429,-0.0034118371795479607,27087065,-1.0
786,COST,1548828000000,211.35,212.17,209.32,210.48,1590026,1.039999999999992,0.0,1.039999999999992,55.91122495682292,206.0,215.555,55.99162742019875,-44.008372579801254,-0.1535351077839664,-0.7457312466464276,0.005566657151013343,28677091,1.0
787,COST,1548914400000,214.63,214.88,209.72,211.14,4341129,3.280000000000001,0.0,3.280000000000001,67.63097555478095,207.31,215.555,88.78107944208598,-11.21892055791402,0.19400311384526958,-0.5577843745480883,0.014991014849143891,33018220,1.0
788,COST,1549000800000,210.27,215.0,209.365,214.0,3453857,-4.359999999999985,4.359999999999985,0.0,48.04327378521136,207.31,215.555,35.90054578532452,-64.09945421467549,0.11627376491668429,-0.42297274665513374,-0.01554379886698809,29564363,-1.0
789,COST,1549260000000,211.18,211.19,207.9,210.7,1630281,0.9099999999999966,0.0,0.9099999999999966,51.43093800356289,207.31,215.555,46.93753790175867,-53.062462098241326,0.12664223778992323,-0.3130497497661223,-0.005743879472693059,31194644,1.0
790,COST,1549346400000,211.61,212.52,209.64,211.49,2074517,0.4300000000000068,0.0,0.4300000000000068,53.09827120989337,207.31,215.555,52.15281989084305,-47.84718010915696,0.16762446310644918,-0.216914907191608,-0.002263190155122774,33269161,1.0
791,COST,1549432800000,211.6,212.26,210.48,212.26,1618762,-0.010000000000019327,0.010000000000019327,0.0,53.049403426634946,207.31,215.555,52.031534263189684,-47.96846573681031,0.19702507310537953,-0.13412691113221048,0.00613380248205031,31650399,-1.0
792,COST,1549519200000,209.05,210.1,206.27,210.07,2526625,-2.549999999999983,2.549999999999983,0.0,41.745262952191034,206.27,215.555,29.940764674205735,-70.05923532579426,0.014395635702953768,-0.10442240176517763,-9.566174008701633e-05,29123774,-1.0
793,COST,1549605600000,207.75,208.49,205.75,207.83,2013683,-1.3000000000000114,1.3000000000000114,0.0,37.095513924797075,205.75,215.555,20.397756246812836,-79.60224375318717,-0.2325578623639899,-0.13004949388494008,-0.014328414859799854,27110091,-1.0
794,COST,1549864800000,208.72,208.92,206.76,208.65,2376584,0.9699999999999989,0.0,0.9699999999999989,42.59992731079485,205.75,215.0,32.1081081081081,-67.8918918918919,-0.3460107983283649,-0.17324175477362505,-0.007560268175550444,29486675,1.0
795,COST,1549951200000,211.9,212.75,209.255,210.06,2091247,3.180000000000007,0.0,3.180000000000007,56.87459243504855,205.75,215.0,66.48648648648656,-33.51351351351345,-0.17728006958532205,-0.17404941773596447,0.0026023184291459334,31577922,1.0
796,COST,1550037600000,212.8,213.505,211.295,212.23,1703041,0.9000000000000057,0.0,0.9000000000000057,60.113804602050564,205.75,215.0,76.21621621621634,-23.78378378378366,0.028731527790284872,-0.1334932286307146,-0.008526301076270726,33280963,1.0
797,COST,1550124000000,213.84,214.545,211.14,212.0,1411054,1.039999999999992,0.0,1.039999999999992,63.74472040233074,205.75,215.0,87.4594594594595,-12.540540540540505,0.2727721635822604,-0.05224015018811958,0.016978170923098945,34692017,1.0
798,COST,1550210400000,216.47,217.25,214.04,215.15,2635500,2.6299999999999955,0.0,2.6299999999999955,71.35378302577837,205.75,217.25,93.21739130434781,-6.7826086956521845,0.670664146998007,0.09234070924910578,0.025049720617482674,37327517,1.0
799,COST,1550556000000,218.12,219.6,216.51,216.67,1938119,1.6500000000000057,0.0,1.6500000000000057,75.1319242216542,205.75,219.6,89.31407942238275,-10.68592057761726,1.1063839157889674,0.2951493505570782,0.03076414158121077,39265636,1.0
800,COST,1550642400000,217.11,219.07,215.0573,218.23,1785610,-1.009999999999991,1.009999999999991,0.0,68.72956768438422,205.75,219.6,82.02166064981962,-17.978339350180374,1.35458163874398,0.5070358081944587,0.026039697542533213,37480026,-1.0
801,COST,1550728800000,215.23,216.72,214.33,216.6,1615527,-1.8800000000000239,1.8800000000000239,0.0,58.09668383868039,205.75,219.6,68.44765342960284,-31.552346570397155,1.3836302064443657,0.6823546878444402,0.029562305668500155,35864499,-1.0
802,COST,1550815200000,216.29,216.59,214.25,215.17,1542501,1.0600000000000023,0.0,1.0600000000000023,61.92848960762418,205.75,219.6,76.10108303249095,-23.898916967509052,1.4751795947319124,0.8409196692219347,0.04110709987966299,37407000,1.0
803,COST,1551074400000,217.05,219.09,216.55,217.37,1794018,0.7600000000000193,0.0,0.7600000000000193,64.60605277940721,205.75,219.6,81.58844765342972,-18.411552346570282,1.590721940595671,0.990880123496682,0.03990992717516306,39201018,1.0
804,COST,1551160800000,217.61,218.91,216.13,216.89,1884099,0.5600000000000023,0.0,0.5600000000000023,66.6030122815387,205.75,219.6,85.63176895306871,-14.368231046931273,1.707791049851437,1.1342623087676331,0.02694667295894293,41085117,1.0
805,COST,1551247200000,218.05,218.86,216.45,216.51,1482708,0.4399999999999977,0.0,0.4399999999999977,68.2281683274479,205.75,219.6,88.80866425992792,-11.191335740072084,1.8151495707770096,1.2704397611695084,0.024671052631578982,42567825,1.0
806,COST,1551333600000,218.74,219.6917,217.52,218.49,2055597,0.6899999999999977,0.0,0.6899999999999977,70.79930563824216,205.75,219.6917,93.17371626128816,-6.8262837387118385,1.9336196419165503,1.4030757373189169,0.02291432846988406,44623422,1.0
807,COST,1551420000000,219.44,220.57,215.77,219.76,2178555,0.6999999999999886,0.0,0.6999999999999886,73.32608136242789,206.76,220.57,91.81752353367129,-8.182476466328712,2.0602429780828118,1.5345091854716961,0.01372014597865756,46801977,1.0
808,COST,1551679200000,218.41,221.08,215.87,220.43,2444661,-1.0300000000000011,1.0300000000000011,0.0,63.93342225133078,209.255,221.08,77.42071881606755,-22.579281183932448,2.0538055009745335,1.6383684485722638,0.001329543370621744,44357316,-1.0
809,COST,1551765600000,219.82,221.61,218.9,218.91,2160246,1.4099999999999966,0.0,1.4099999999999966,70.00275849938643,211.14,221.61,82.90353390639909,-17.096466093600917,2.137835335131456,1.7382618258841027,0.012482151904564365,46517562,1.0
810,COST,1551852000000,219.23,221.91,218.23,220.5,1985311,-0.5900000000000034,0.5900000000000034,0.0,64.7425061874676,211.14,221.91,75.11606313834722,-24.883936861652778,2.132242352377574,1.817057931182797,0.0185847697811643,44532251,-1.0
811,COST,1551938400000,216.79,219.39,216.22,218.13,3279102,-2.4399999999999977,2.4399999999999977,0.0,47.65479922935703,214.04,221.91,34.94282083862768,-65.05717916137232,1.908917453050833,1.8354298355564043,0.0023117111285773095,41253149,-1.0
812,COST,1552024800000,227.82,228.7,223.77,225.48,6782749,11.030000000000001,0.0,11.030000000000001,77.97534421716189,214.25,228.7,93.91003460207615,-6.089965397923849,2.5920797973797107,1.9867598279210656,0.049619903248099506,48035898,1.0
813,COST,1552280400000,229.69,229.91,227.06,227.53,3748431,1.8700000000000045,0.0,1.8700000000000045,80.21698775909465,214.25,229.91,98.59514687100895,-1.404853128991053,3.2469553686009647,2.2387989360570457,0.05551215477229898,51784329,1.0
814,COST,1552366800000,232.96,233.4,229.9,230.32,2647259,3.2700000000000102,0.0,3.2700000000000102,83.58743759316604,214.25,233.4,97.70234986945171,-2.2976501305482904,3.9838868803042544,2.5878165249064877,0.06837881219903696,54431588,1.0
815,COST,1552453200000,236.38,237.45,232.95,234.25,2421178,3.4199999999999875,0.0,3.4199999999999875,86.38638732143735,214.25,237.45,95.38793103448279,-4.6120689655172145,4.788674966326141,3.0279882131904188,0.08064368656852872,56852766,1.0
816,COST,1552539600000,233.84,236.38,233.28,236.13,2300252,-2.539999999999992,2.539999999999992,0.0,75.37147068652176,215.77,237.45,83.34870848708492,-16.65129151291508,5.162014065450876,3.4547933836425107,0.06562158220926007,54552514,-1.0
817,COST,1552626000000,233.6,235.65,233.18,234.17,5073781,-0.2400000000000091,0.2400000000000091,0.0,74.3380609174252,215.77,237.45,82.24169741697418,-17.758302583025824,5.376544538378397,3.839143614589688,0.06954809761457814,49478733,-1.0
818,COST,1552885200000,236.59,236.68,233.49,233.58,1735414,2.990000000000009,0.0,2.990000000000009,78.56313801701322,215.77,237.45,96.03321033210338,-3.966789667896615,5.721871324415815,4.215689156554914,0.07628969156582666,51214147,1.0
819,COST,1552971600000,237.05,238.05,236.29,237.52,1852346,0.46000000000000796,0.0,0.46000000000000796,79.17187528152454,215.77,238.05,95.5116696588869,-4.488330341113106,5.963915144536003,4.565334354151132,0.0812844957350729,53066493,1.0
820,COST,1553058000000,236.98,238.49,235.775,237.03,1499470,-0.0700000000000216,0.0700000000000216,0.0,78.77907870930727,215.77,238.49,93.35387323943654,-6.646126760563466,6.080001725603893,4.8682678284416845,0.09313160201116277,51567023,-1.0
821,COST,1553144400000,239.54,239.85,236.5526,236.68,1617047,2.5600000000000023,0.0,2.5600000000000023,82.45271753637711,215.87,239.85,98.70725604670558,-1.292743953294422,6.3058815059161475,5.155790563936577,0.051444122552892546,53184070,1.0
822,COST,1553230800000,237.56,240.34,236.9,239.75,1873609,-1.9799999999999898,1.9799999999999898,0.0,71.41906036717825,216.22,240.34,88.47429519071311,-11.525704809286902,6.253042228318492,5.375240896812961,0.03426357264138624,51310461,-1.0
823,COST,1553490000000,236.97,238.08,235.785,236.93,1357121,-0.5900000000000034,0.5900000000000034,0.0,68.277628340084,216.22,240.34,86.02819237147594,-13.971807628524063,6.093318666345908,5.518856450719551,0.017213255494505475,49953340,-1.0
824,COST,1553576400000,239.07,240.25,237.36,238.0,1193004,2.0999999999999943,0.0,2.0999999999999943,73.1313471903565,216.22,240.34,94.73466003316744,-5.265339966832546,6.066260962046925,5.628337352985026,0.011379981385904125,51146344,1.0
825,COST,1553662800000,239.41,240.21,238.16,238.71,1351237,0.3400000000000034,0.0,0.3400000000000034,73.87800705000771,223.77,240.34,94.38744719372355,-5.6125528062764465,6.003053234039527,5.7032805291959265,0.023819705781731093,52497581,1.0
826,COST,1553749200000,241.22,241.95,239.5834,239.98,1396657,1.8100000000000023,0.0,1.8100000000000023,77.68679229116951,227.06,241.95,95.09738079247823,-4.902619207521763,6.0295081111363515,5.768526045584013,0.03261986301369868,53894238,1.0
827,COST,1553835600000,242.14,242.44,240.77,241.66,1967964,0.9199999999999875,0.0,0.9199999999999875,79.44456981532142,229.9,242.44,97.60765550239225,-2.392344497607748,6.054912836938826,5.825803403854976,0.02345830339405719,55862202,1.0
828,COST,1554094800000,244.19,244.41,242.58,243.07,1610207,2.0500000000000114,0.0,2.0500000000000114,82.90668912683854,232.95,244.41,98.0802792321117,-1.9197207678882957,6.169347732229852,5.894512269529952,0.030120227800042088,57472409,1.0
829,COST,1554181200000,240.5,244.19,240.31,244.0,1574327,-3.6899999999999977,3.6899999999999977,0.0,61.42087291392615,233.18,244.41,65.18254674977739,-34.81745325022262,5.89433977005686,5.894477769635334,0.014853574141277859,55898082,-1.0
830,COST,1554267600000,242.48,243.55,241.02,241.69,1663865,1.9799999999999898,0.0,1.9799999999999898,66.75512694768251,233.18,244.41,82.81389136242201,-17.186108637577995,5.7696544461866495,5.869513104945598,0.012273524254821755,57561947,1.0
831,COST,1554354000000,244.4,244.76,241.25,242.17,1320012,1.920000000000016,0.0,1.920000000000016,71.20921456252029,233.49,244.76,96.80567879325656,-3.194321206743441,5.759377859720473,5.847486055900574,0.028792726048156192,58881959,1.0
832,COST,1554440400000,245.87,247.09,244.01,244.96,1616207,1.4699999999999989,0.0,1.4699999999999989,74.25620228180155,235.775,247.09,89.21785240830756,-10.782147591692436,5.80295742462792,5.838580329646044,0.03755749672954378,60498166,1.0
833,COST,1554699600000,246.52,246.83,245.2,245.99,1244150,0.6500000000000057,0.0,0.6500000000000057,75.57505043382388,235.775,247.09,94.96243923994703,-5.037560760052968,5.822822241296933,5.835428711976222,0.03116242104822864,61742316,1.0
834,COST,1554786000000,244.91,245.68,244.005,245.11,1450175,-1.6100000000000136,1.6100000000000136,0.0,65.92300024587172,235.785,247.09,80.71649712516582,-19.283502874834195,5.643595847049454,5.797062138990869,0.022973142308174266,60292141,-1.0
835,COST,1554872400000,245.61,246.67,244.71,245.28,1556647,0.700000000000017,0.0,0.700000000000017,67.97488024838961,235.785,247.09,86.90844758956224,-13.091552410437762,5.4947022806493635,5.736590167322569,0.018199154298980336,61848788,1.0
836,COST,1554958800000,241.24,244.18,240.92,243.62,2719985,-4.3700000000000045,4.3700000000000045,0.0,47.411133391906304,235.785,247.09,48.25298540468827,-51.747014595311725,4.966826098649932,5.582637353588042,-0.0037168580160237275,59128803,-1.0
837,COST,1555045200000,241.95,242.72,240.9,241.51,2187612,0.7099999999999795,0.0,0.7099999999999795,50.23351408108592,237.36,247.09,47.17368961973258,-52.82631038026743,4.553284063195292,5.376766695509493,-0.009173184815102986,61316415,1.0
838,COST,1555304400000,246.33,246.75,241.96,242.37,1859679,4.380000000000024,0.0,4.380000000000024,63.99002436192008,238.16,247.09,91.48936170212777,-8.510638297872232,4.526796325293475,5.206772621466289,0.024241164241164403,63176094,1.0
839,COST,1555390800000,245.34,246.82,244.25,246.65,1360535,-0.9900000000000091,0.9900000000000091,0.0,59.687127182315656,239.5834,247.09,76.68718194655368,-23.31281805344633,4.375482042603892,5.04051450569381,0.011794787198944334,61815559,-1.0
840,COST,1555477200000,245.56,246.46,244.32,246.3,1363036,0.21999999999999886,0.0,0.21999999999999886,60.3704148957555,240.31,247.09,77.43362831858406,-22.56637168141594,4.2246177807517995,4.8773351607054085,0.004746317512275056,63178595,1.0
841,COST,1555563600000,245.81,247.25,244.701,246.79,1365116,0.25,0.0,0.25,61.23200060662329,240.31,247.25,79.25072046109513,-20.749279538904876,4.078218512568384,4.717511831078004,-0.0002440313987066567,64543711,1.0
842,COST,1555909200000,243.42,245.77,242.56,245.19,1300078,-2.390000000000015,2.390000000000015,0.0,49.38782887221871,240.31,247.25,44.81268011527358,-55.18731988472643,3.7263875359289784,4.5192869720481985,-0.01257504462112613,63243633,-1.0
843,COST,1555995600000,245.58,246.53,242.21,244.65,1524628,2.160000000000025,0.0,2.160000000000025,57.88324905925344,240.9,247.25,73.70078740157497,-26.299212598425026,3.5805782233369428,4.331545222305947,0.0027356988281410644,64768261,1.0
844,COST,1556082000000,247.96,248.7,245.6,245.68,1156425,2.3799999999999955,0.0,2.3799999999999955,65.29039189151968,240.9,248.7,90.51282051282074,-9.48717948717926,3.615393397535172,4.188314857351792,0.009568014331664099,65924686,1.0
845,COST,1556168400000,245.6,247.15,243.94,246.21,1278195,-2.3600000000000136,2.3600000000000136,0.0,54.35323988696417,240.9,248.7,60.25641025641024,-39.74358974358976,3.4132070707961475,4.033293300040663,0.018073288011938304,64646491,-1.0
846,COST,1556254800000,243.82,245.89,242.06,245.62,1842939,-1.7800000000000011,1.7800000000000011,0.0,47.43758308705045,240.9,248.7,37.43589743589736,-62.56410256410264,3.073907731376579,3.841416186307846,0.007728869601157262,62803552,-1.0
847,COST,1556514000000,244.28,245.75,243.49,245.0,1429707,0.46000000000000796,0.0,0.46000000000000796,49.35889086583835,240.9,248.7,43.33333333333337,-56.66666666666663,2.8097397847500076,3.6350809059962783,-0.008322169447489203,64233259,1.0
848,COST,1556600400000,245.53,245.79,243.02,244.77,1427578,1.25,0.0,1.25,54.56606450133851,240.9,248.7,59.35897435897443,-40.64102564102557,2.670465868905552,3.4421578985781336,0.0007744354772967199,65660837,1.0
849,COST,1556686800000,241.59,245.46,241.55,245.34,1350376,-3.9399999999999977,3.9399999999999977,0.0,39.71425459604285,240.9,248.7,8.846153846153836,-91.15384615384616,2.2166134747956505,3.197049013821637,-0.016167128196774683,64310461,-1.0
850,COST,1556773200000,242.69,242.885,240.42,241.76,1237645,1.0999999999999943,0.0,1.0999999999999943,44.57401172436361,240.42,248.7,27.41545893719819,-72.5845410628018,1.9235198500678052,2.942343181070871,-0.012692730157438659,65548106,1.0
851,COST,1556859600000,244.62,244.88,242.72,243.27,905868,1.9300000000000068,0.0,1.9300000000000068,52.35030430450043,240.42,248.7,50.72463768115962,-49.27536231884038,1.8259277526303492,2.719060095382767,0.004929751047572095,66453974,1.0
852,COST,1557118800000,244.23,244.83,242.06,242.85,1195175,-0.3900000000000148,0.3900000000000148,0.0,50.69203863864919,240.42,248.7,46.01449275362321,-53.9855072463768,1.6975473030411479,2.514757536914443,-0.0054971903249451115,65258799,-1.0
853,COST,1557205200000,240.18,242.735,238.22,241.72,1775187,-4.049999999999983,4.049999999999983,0.0,36.745245147527925,238.22,248.7,18.702290076335974,-81.29770992366403,1.254542138229283,2.262714457177411,-0.03137602839167608,63483612,-1.0
854,COST,1557291600000,241.34,243.05,238.19,239.56,1611887,1.1599999999999966,0.0,1.1599999999999966,42.0173445152929,238.19,248.7,29.971455756422532,-70.02854424357746,0.9856971556758651,2.0073109968771017,-0.017345276872964166,65095499,1.0
855,COST,1557378000000,243.47,244.0556,240.16,240.66,1919368,2.1299999999999955,0.0,2.1299999999999955,50.71963961450435,238.19,248.7,50.237868696479595,-49.7621313035204,0.9337451362314937,1.79259782474798,-0.0014354851939955005,67014867,1.0
856,COST,1557464400000,247.02,248.55,240.025,242.94,2036492,3.5500000000000114,0.0,3.5500000000000114,61.75737654067921,238.19,248.7,84.01522359657488,-15.98477640342512,1.1655919000711492,1.6671966398126137,0.011216636646471212,69051359,1.0
857,COST,1557723600000,241.92,244.93,240.67,244.12,1962786,-5.100000000000023,5.100000000000023,0.0,45.03645829663984,238.19,248.7,35.4900095147478,-64.50999048525222,0.927117519603371,1.5191808157707651,-0.01470288763083949,67088573,-1.0
858,COST,1557810000000,242.73,245.09,241.81,242.29,1635179,0.8100000000000023,0.0,0.8100000000000023,47.63468906123281,238.19,248.55,43.82239382239369,-56.17760617760631,0.7943285603239758,1.3742103646814074,0.004718738358375774,68723752,1.0
859,COST,1557896400000,244.67,245.4,241.23,242.11,1194788,1.9399999999999977,0.0,1.9399999999999977,53.68514296619324,238.19,248.55,62.548262548262365,-37.451737451737635,0.835997283847604,1.266567748514647,0.008158556182784604,69918540,1.0
860,COST,1557982800000,247.44,249.73,245.21,245.63,1801038,2.7700000000000102,0.0,2.7700000000000102,61.09164412830231,238.19,249.73,80.15597920277303,-19.84402079722698,1.0800853460513622,1.2292712680219902,0.011528084375766356,71719578,1.0
861,COST,1558069200000,248.35,250.0498,245.5935,245.88,1672148,0.9099999999999966,0.0,0.9099999999999966,63.31539506459302,238.19,250.0498,85.6675491998178,-14.332450800182206,1.3316063595037804,1.2497382863183484,0.016869344470376246,73391726,1.0
862,COST,1558328400000,248.9,249.94,247.15,247.15,1600493,0.5500000000000114,0.0,0.5500000000000114,64.72151509149455,238.19,250.0498,90.30506416634346,-9.69493583365654,1.5573666252057592,1.3112639540958306,0.036306103755516794,74992219,1.0
863,COST,1558414800000,249.93,250.83,248.1,249.11,1504191,1.0300000000000011,0.0,1.0300000000000011,67.41995452915233,238.19,250.83,92.879746835443,-7.120253164556998,1.798661800610887,1.4087435233988421,0.03559293942156305,76496410,1.0
864,COST,1558501200000,249.51,251.01,249.14,251.01,1242294,-0.4200000000000159,0.4200000000000159,0.0,65.07790390218572,238.19,251.01,88.29953198127924,-11.700468018720755,1.933708883328734,1.5137365953848207,0.024807984556618923,75254116,-1.0
865,COST,1558587600000,248.53,249.92,247.1774,248.63,1822807,-0.9799999999999898,0.9799999999999898,0.0,59.511984090736576,238.19,251.01,80.65522620904844,-19.34477379095157,1.9393017956196275,1.5988496354317823,0.006112865355031971,73431309,-1.0
866,COST,1558674000000,247.3,249.5635,246.77,249.11,1340428,-1.2299999999999898,1.2299999999999898,0.0,52.95321065926749,238.19,251.01,71.06084243369749,-28.93915756630251,1.823463743475827,1.6437724570405914,0.02223875661375674,72090881,-1.0
867,COST,1559019600000,246.31,250.2,246.14,248.58,3164140,-0.9900000000000091,0.9900000000000091,0.0,48.0365729759308,238.19,251.01,63.338533541341725,-36.661466458658275,1.6329528622410123,1.6416085380806757,0.014748897952457485,68926741,-1.0
868,COST,1559106000000,240.69,244.77,238.91,244.13,2594886,-5.6200000000000045,5.6200000000000045,0.0,29.87033421988336,238.91,251.01,14.710743801652908,-85.28925619834709,1.0167639625588833,1.5166396229763175,-0.01626680835410954,66331855,-1.0
869,COST,1559192400000,241.54,243.58,240.745,242.15,2030255,0.8499999999999943,0.0,0.8499999999999943,34.21212954606182,238.91,251.01,21.735537190082617,-78.26446280991738,0.5902140957131792,1.33135451752369,-0.02384416424183644,68362110,1.0
870,COST,1559278800000,239.58,240.66,233.05,238.98,4058490,-1.9599999999999795,1.9599999999999795,0.0,29.373634348118372,233.05,251.01,36.358574610245036,-63.64142538975497,0.09294324168072876,1.0836722623550978,-0.035313066237165236,64303620,-1.0
871,COST,1559538000000,241.07,241.54,238.0846,239.78,2512452,1.4899999999999807,0.0,1.4899999999999807,37.1681344160585,233.05,251.01,44.65478841870819,-55.34521158129181,-0.17885521366304147,0.8311667671514699,-0.03145841703495389,66816072,1.0
872,COST,1559624400000,245.61,245.82,242.5,243.0,1761622,4.5400000000000205,0.0,4.5400000000000205,54.7322942935324,233.05,251.01,69.93318485523395,-30.066815144766057,-0.02759924319275342,0.6594135650826253,-0.017284839755131398,68577694,1.0
873,COST,1559710800000,247.96,248.76,245.02,246.1,1825514,2.3499999999999943,0.0,2.3499999999999943,61.20879750874609,233.05,251.01,83.01781737193772,-16.982182628062283,0.2786850555310991,0.58326786317232,-0.006212175864694691,70403208,1.0
874,COST,1559797200000,251.21,251.94,247.735,248.0,1487759,3.25,0.0,3.25,68.41891786441602,233.05,251.94,96.13552143991535,-3.86447856008465,0.7747347476305322,0.6215612400639625,0.010783406429807352,71890967,1.0
875,COST,1559883600000,256.01,256.6,251.02,251.16,2270617,4.799999999999983,0.0,4.799999999999983,76.01586514099701,233.05,256.6,97.49469214437354,-2.505307855626461,1.5374547656839752,0.8047399451879652,0.035220380105135396,74161584,1.0
876,COST,1560142800000,256.85,258.825,256.11,256.4,1839825,0.8400000000000318,0.0,0.8400000000000318,77.12688878720087,233.05,258.825,92.33753637245405,-7.662463627545946,2.1845151243789758,1.0806949810261675,0.042791604076164225,76001409,1.0
877,COST,1560229200000,257.11,259.615,256.2078,258.91,1613472,0.2599999999999909,0.0,0.2599999999999909,77.49914354946856,233.05,259.615,90.57029926595146,-9.429700734048543,2.6873172273522243,1.4020194302913789,0.06822053263534023,77614881,1.0
878,COST,1560315600000,257.23,258.75,255.77,257.58,1071667,0.12000000000000455,0.0,0.12000000000000455,77.69248369657552,233.05,259.615,91.0220214568041,-8.977978543195901,3.0601984507375164,1.7336552343806069,0.06495818497971362,78686548,1.0
879,COST,1560402000000,259.71,259.87,257.5474,257.71,1228541,2.4799999999999613,0.0,2.4799999999999613,81.48599740294671,233.05,259.87,99.40343027591341,-0.596569724086596,3.5153025607887685,2.0899846996622395,0.08402203856749302,79915089,1.0
880,COST,1560488400000,260.15,261.2,258.91,260.0,1288089,0.4399999999999977,0.0,0.4399999999999977,82.10883935362905,233.05,261.2,96.26998223801061,-3.7300177619893864,3.866904897030736,2.445368739135939,0.07914713568672993,81203178,1.0
881,COST,1560747600000,261.43,262.25,260.43,261.13,1192307,1.2800000000000296,0.0,1.2800000000000296,83.92417150709156,233.05,262.25,97.19178082191783,-2.8082191780821697,4.20041778272423,2.7963785478535974,0.06441105818167014,82395485,1.0
882,COST,1560834000000,262.74,264.1956,262.05,263.61,2763187,1.3100000000000023,0.0,1.3100000000000023,85.6442656982289,233.05,264.1956,95.3264666598171,-4.673533340182896,4.51835046772365,3.1407729318276085,0.05960638812711738,85158672,1.0
883,COST,1560920400000,263.66,264.1008,260.94,262.31,1628489,0.9200000000000159,0.0,0.9200000000000159,86.78966553490744,233.05,264.1956,98.28033494297755,-1.7196650570224625,4.789342167165103,3.4704867788951077,0.049560128975757456,86787161,1.0
884,COST,1561006800000,267.35,267.79,264.55,265.0,1745108,3.6899999999999977,0.0,3.6899999999999977,90.35212432422229,238.0846,267.79,98.5187878298222,-1.4812121701778038,5.241437177642865,3.824676858644659,0.04429514472090945,88532269,1.0
885,COST,1561093200000,266.13,268.94,265.99,266.77,2964243,-1.2200000000000273,1.2200000000000273,0.0,81.92404183409649,242.5,268.94,89.37216338880482,-10.627836611195168,5.438589255052676,4.1474593379262625,0.036130036986568026,85568026,-1.0
886,COST,1561352400000,266.77,267.97,266.52,267.31,1586110,0.6399999999999864,0.0,0.6399999999999864,82.89010559050129,245.02,268.94,90.92809364548488,-9.071906354515122,5.582129039290521,4.434393278199114,0.03757146746528717,87154136,1.0
887,COST,1561438800000,266.36,267.08,265.36,266.71,1182443,-0.40999999999996817,0.40999999999996817,0.0,79.73994856738268,247.735,268.94,87.83305824098096,-12.166941759019032,5.598268425353865,4.667168307630065,0.035493527193562135,85971693,-1.0
888,COST,1561525200000,264.41,266.8195,264.34,266.45,1334353,-1.9499999999999886,1.9499999999999886,0.0,65.97937941644028,251.02,268.94,74.72098214285727,-25.279017857142723,5.391559757165908,4.8120465975372335,0.018097108313118726,84637340,-1.0
889,COST,1561611600000,265.58,266.48,262.99,264.9,1122854,1.169999999999959,0.0,1.169999999999959,69.61007047752679,255.77,268.94,74.48747152619578,-25.51252847380423,5.261499578304495,4.901937193690686,0.020872573515279713,85760194,1.0
890,COST,1561698000000,264.26,266.385,263.36,265.5,1952692,-1.3199999999999932,1.3199999999999932,0.0,61.11905433250104,255.77,268.94,64.46469248291564,-35.53530751708437,4.9943413233184515,4.920418019616239,0.010825077458592958,83807502,-1.0
891,COST,1561957200000,263.55,267.0,261.84,266.43,1960377,-0.7099999999999795,0.7099999999999795,0.0,56.817715220228386,255.77,268.94,59.07365223993932,-40.92634776006068,4.671475552906884,4.870629526274368,0.003082895638273575,81847125,-1.0
892,COST,1562043600000,265.47,265.57,261.67,263.92,1201390,1.920000000000016,0.0,1.920000000000016,64.59286304420064,257.5474,268.94,69.5416322876256,-30.458367712374397,4.51844424500149,4.800192470019793,0.006864901767427822,83048515,1.0
893,COST,1562130000000,269.14,269.16,265.14,265.14,986472,3.669999999999959,0.0,3.669999999999959,74.6569546403882,258.91,269.16,99.80487804878011,-0.1951219512198893,4.639819211799249,4.768117818375685,0.006695343183093172,84034987,1.0
894,COST,1562302800000,268.25,268.61,266.27,268.2,1081451,-0.8899999999999864,0.8899999999999864,0.0,69.1566168858213,260.43,269.16,89.57617411225633,-10.423825887743678,4.611040975395156,4.736702449779579,0.007966031638672932,82953536,-1.0
895,COST,1562562000000,269.4,269.69,267.35,268.33,1236007,1.1499999999999773,0.0,1.1499999999999773,72.20925307180858,260.94,269.69,96.68571428571406,-3.314285714285948,4.627684340316193,4.714898827886902,0.00985867976159227,84189543,1.0
896,COST,1562648400000,269.97,270.78,268.49,269.36,1400472,0.57000000000005,0.0,0.57000000000005,73.69801900138853,260.94,270.78,91.76829268292737,-8.231707317072637,4.6334569556781275,4.698610453445148,0.013553086048956331,85590015,1.0
897,COST,1562734800000,271.42,271.53,269.34,270.05,1256976,1.4499999999999886,0.0,1.4499999999999886,77.27183101943137,261.67,271.53,98.88438133874283,-1.1156186612571732,4.700846247421168,4.699057612240352,0.026511856586362015,86846991,1.0
898,COST,1562821200000,276.54,276.77,271.813,272.33,1985628,5.1200000000000045,0.0,5.1200000000000045,85.37060737731215,261.67,276.77,98.47682119205324,-1.5231788079467674,5.108506276593914,4.7809473451110645,0.04126816778371878,88832619,1.0
899,COST,1562907600000,279.44,280.0,276.01,276.5,2046480,2.8999999999999773,0.0,2.8999999999999773,88.13396206963542,261.67,280.0,96.94489907255863,-3.055100927441368,5.60102047293617,4.944961970676086,0.05744342692802551,90879099,1.0
900,COST,1563166800000,280.58,280.7,278.9,279.94,1568031,1.1399999999999864,0.0,1.1399999999999864,89.07038087191157,261.67,280.7,99.36941671045714,-0.6305832895428519,6.014004296589633,5.158770435858796,0.06461771959779927,92447130,1.0
901,COST,1563253200000,280.65,281.37,279.7765,281.0,1379215,0.06999999999999318,0.0,0.06999999999999318,89.13115084580777,261.67,281.37,96.34517766497449,-3.6548223350255213,6.274615505473832,5.381939449781804,0.057181602440953494,93826345,1.0
902,COST,1563339600000,281.56,282.85,280.22,281.05,1716730,0.910000000000025,0.0,0.910000000000025,89.96784994293021,261.67,282.85,93.90934844192626,-6.090651558073748,6.479885079323594,5.601528575690162,0.04614698669837258,95543075,1.0
903,COST,1563426000000,282.91,283.06,279.19,282.2,1696366,1.3500000000000227,0.0,1.3500000000000227,91.13589813177919,261.67,283.06,99.29873772791035,-0.7012622720896557,6.674556283002801,5.816134117152691,0.05465051258154707,97239441,1.0
904,COST,1563512400000,281.51,284.31,281.35,283.07,1607618,-1.400000000000034,1.400000000000034,0.0,79.9915870131169,261.67,284.31,87.6325088339222,-12.367491166077796,6.639332225680221,5.980773738858198,0.04495174461766904,95631823,-1.0
905,COST,1563771600000,280.17,282.32,279.32,281.22,1461682,-1.339999999999975,1.339999999999975,0.0,70.4741836978512,261.67,284.31,81.71378091872796,-18.286219081272034,6.429178537171879,6.070454698520935,0.03778197577508613,94170141,-1.0
906,COST,1563858000000,280.1,282.08,279.0243,281.85,1117826,-0.06999999999999318,0.06999999999999318,0.0,69.97237071030763,265.14,284.31,78.03860198226408,-21.96139801773592,6.185677173956776,6.093499193608104,0.031979957261808245,93052315,-1.0
907,COST,1563944400000,280.83,281.24,279.01,279.83,1257368,0.7299999999999613,0.0,0.7299999999999613,72.34212530819491,266.27,284.31,80.70953436807088,-19.290465631929127,5.98264132330155,6.0713276195467945,0.0155131264916466,94309683,1.0
908,COST,1564030800000,279.8,281.94,279.34,281.2,1600168,-1.0299999999999727,1.0299999999999727,0.0,64.10565827538957,267.35,284.31,73.40801886792455,-26.59198113207545,5.673224160271957,5.991706927691828,0.0012882908674491933,92709515,-1.0
909,COST,1564117200000,281.37,281.77,279.12,279.8,1447719,1.5699999999999932,0.0,1.5699999999999932,70.0941354358115,268.49,284.31,81.41592920353983,-18.58407079646017,5.491393344106086,5.891644210974681,0.002815596264879927,94157234,1.0
910,COST,1564376400000,280.13,281.3,279.54,281.01,1257360,-1.240000000000009,1.240000000000009,0.0,60.84344514681378,269.34,284.31,72.07748830995324,-27.922511690046754,5.187435942903676,5.750802557360481,-0.0018528416176731843,92899874,-1.0
911,COST,1564462800000,279.5,280.57,279.1,280.27,978168,-0.6299999999999955,0.6299999999999955,0.0,56.47417288403261,271.813,284.31,61.510762583019954,-38.489237416980046,4.839920190475539,5.568626083983493,-0.007316380167637471,91921706,-1.0
912,COST,1564549200000,275.63,279.72,272.6301,279.02,1886852,-3.8700000000000045,3.8700000000000045,0.0,37.42501980706419,272.6301,284.31,25.68429524225357,-74.31570475774643,4.203776279707313,5.295656123128258,-0.025732565126718843,90034854,-1.0
913,COST,1564635600000,274.57,280.93,274.31,275.75,2634609,-1.0600000000000023,1.0600000000000023,0.0,33.81974083914574,272.6301,284.31,16.608875075984983,-83.39112492401502,3.57290824386655,4.951106547275916,-0.024652765443501146,87400245,-1.0
914,COST,1564722000000,272.5,274.9414,270.5,274.3,1969165,-2.069999999999993,2.069999999999993,0.0,27.787956179203235,270.5,284.31,14.482259232440258,-85.51774076755974,2.872793307024267,4.535443899225586,-0.027376235856801268,85431080,-1.0
915,COST,1564981200000,265.1,270.5524,262.71,270.09,3329760,-7.399999999999977,7.399999999999977,0.0,16.00990262562071,262.71,284.31,11.064814814815003,-88.93518518518499,1.701218432780081,3.968598805936485,-0.05355230274901823,82101320,-1.0
916,COST,1565067600000,269.31,270.2299,264.0485,266.47,2383225,4.2099999999999795,0.0,4.2099999999999795,34.29224478957303,262.71,284.31,30.55555555555563,-69.44444444444437,1.0997712414744,3.3948332930440683,-0.041021258412562656,84484545,1.0
917,COST,1565154000000,274.3,274.855,263.59,268.18,3037469,4.990000000000009,0.0,4.990000000000009,49.36575616914431,262.71,284.31,53.6574074074075,-46.3425925925925,1.0140816045087035,2.9186829553369953,-0.01965689778413149,87522014,1.0
918,COST,1565240400000,274.8,274.84,271.0,273.04,2046674,0.5,0.0,0.5,50.67400695832503,262.71,282.32,61.65221825599196,-38.34778174400804,0.9752754034158215,2.530001444952761,-0.023350037317411254,89568688,1.0
919,COST,1565326800000,273.94,275.47,271.9148,274.58,1284267,-0.8600000000000136,0.8600000000000136,0.0,48.202333502242055,262.71,282.08,57.976251935983555,-42.023748064016445,0.8651534463953112,2.197031845241271,-0.022096883589761918,88284421,-1.0
920,COST,1565586000000,271.31,274.98,269.3,274.03,1638619,-2.6299999999999955,2.6299999999999955,0.0,41.12434233127509,262.71,281.94,44.72178887155494,-55.278211128445065,0.5592156915058126,1.8694686144941794,-0.02930232558139534,86645802,-1.0
921,COST,1565672400000,276.26,278.16,270.01,271.18,1743336,4.949999999999989,0.0,4.949999999999989,55.35965108233898,262.71,281.94,70.4628185127405,-29.537181487259502,0.7080198357774634,1.637178858750836,0.002285672822261775,88389138,1.0
922,COST,1565758800000,268.15,275.36,268.0,274.0,2122137,-8.110000000000014,8.110000000000014,0.0,37.99348875665604,262.71,281.77,28.541448058761787,-71.45855194123821,0.16958411022642395,1.3436599090459538,-0.023382015515169274,86267001,-1.0
923,COST,1565845200000,271.52,272.9749,268.77,270.53,1651115,3.3700000000000045,0.0,3.3700000000000045,46.10036088333282,262.71,281.3,47.39107046799347,-52.60892953200652,0.014632084678169122,1.077854344172397,-0.0035963302752294313,87918116,1.0
924,COST,1565931600000,274.1,276.07,273.44,274.1,1278604,2.580000000000041,0.0,2.580000000000041,51.68085873400095,262.71,280.93,62.513721185510576,-37.486278814489424,0.09887614346882856,0.8820587040316832,0.03394945303659003,89196720,1.0
925,COST,1566190800000,275.61,277.3815,274.55,276.41,1314844,1.509999999999991,0.0,1.509999999999991,54.838485083991465,262.71,280.93,70.80131723380909,-29.19868276619092,0.2842083702311129,0.7624886372715691,0.023393115740224957,90511564,1.0
926,COST,1566277200000,272.97,276.36,272.85,276.28,1390900,-2.6399999999999864,2.6399999999999864,0.0,48.45113952696071,262.71,280.93,56.3117453347971,-43.6882546652029,0.21557454937271814,0.6531058196917989,-0.0048487057965730385,89120664,-1.0
927,COST,1566363600000,275.68,276.54,274.7,275.41,1682347,2.7099999999999795,0.0,2.7099999999999795,54.70057671094819,262.71,278.16,83.94822006472484,-16.05177993527515,0.37552725896375705,0.5975901075461906,0.003202328966521062,90803011,1.0
928,COST,1566450000000,279.92,280.99,276.868,277.01,2345701,4.240000000000009,0.0,4.240000000000009,62.834595545201346,262.71,280.99,94.14660831509852,-5.853391684901485,0.8348004387406149,0.6450321737850755,0.021829597722129,93148712,1.0
929,COST,1566536400000,274.01,280.13,272.7,278.21,1984929,-5.910000000000025,5.910000000000025,0.0,48.75472296052677,263.59,280.99,59.885057471264346,-40.11494252873566,0.7136634663294217,0.6587584322939448,0.00995171574951148,91163783,-1.0
930,COST,1566795600000,278.46,278.53,275.69,275.75,1426519,4.449999999999989,0.0,4.449999999999989,57.10542047462316,263.59,280.99,85.45977011494239,-14.540229885057613,0.9656084199522184,0.7201284298255997,0.007963512633026859,92590302,1.0
931,COST,1566882000000,292.38,293.44,280.34,281.0,5176415,13.920000000000016,0.0,13.920000000000016,72.9910340896268,268.0,293.44,95.83333333333333,-4.166666666666676,2.2624244557541147,1.0285876350113028,0.0903598732052957,97766717,1.0
932,COST,1566968400000,294.49,299.95,292.42,293.75,5165054,2.1100000000000136,0.0,2.1100000000000136,74.63405735423987,268.0,299.95,82.91079812206578,-17.089201877934215,3.4209848888666556,1.5070670857823736,0.08459781968179159,102931771,1.0
933,COST,1567054800000,296.57,297.725,292.7566,297.48,2614701,2.079999999999984,0.0,2.079999999999984,76.27562690507115,268.0,299.95,89.4209702660407,-10.5790297339593,4.455629275050342,2.0967795236359676,0.08197738051805903,105546472,1.0
934,COST,1567141200000,294.76,298.28,292.83,298.0,1801420,-1.8100000000000023,1.8100000000000023,0.0,71.62173526233998,268.0,299.95,83.75586854460094,-16.24413145539906,5.071084229752103,2.6916404648591947,0.0694822393962482,103745052,-1.0
935,COST,1567486800000,292.05,294.0,290.46,292.57,1843045,-2.7099999999999795,2.7099999999999795,0.0,64.79219033880267,268.0,299.95,75.27386541471056,-24.726134585289454,5.2793058127263635,3.209173534432629,0.0698977909660401,101902007,-1.0
936,COST,1567573200000,296.12,296.3,293.77099999999996,294.0,1376086,4.069999999999993,0.0,4.069999999999993,69.78497573809645,268.77,299.95,87.71648492623481,-12.28351507376518,5.706951716051265,3.7087291707563566,0.07414393499709804,103278093,1.0
937,COST,1567659600000,296.97,299.71,296.675,298.43,1865731,0.8500000000000227,0.0,0.8500000000000227,70.78337969075645,272.7,299.95,89.06422018348637,-10.93577981651362,6.044771706222605,4.175937677849606,0.060910260074307,105143824,1.0
938,COST,1567746000000,303.76,304.64,298.29,299.2,3018101,6.789999999999964,0.0,6.789999999999964,77.60434533246763,272.7,304.64,97.24483406386977,-2.7551659361302305,6.782211622097861,4.697192466699257,0.10857267982920327,108161925,1.0
939,COST,1568005200000,299.0,307.34,298.21,304.5,3397183,-4.759999999999991,4.759999999999991,0.0,65.27720067263354,272.7,307.34,75.92378752886843,-24.076212471131576,6.902972677303865,5.1383485088201795,0.073762838468721,104764742,-1.0
940,COST,1568091600000,297.0,298.25,294.5789,297.38,2724986,-2.0,2.0,0.0,60.60964863073371,272.7,307.34,70.15011547344116,-29.849884526558828,6.759375524803659,5.462553912016876,0.015801354401805856,102039756,-1.0
941,COST,1568178000000,290.69,295.74,287.81,294.3,4754696,-6.310000000000002,6.310000000000002,0.0,48.0914282611038,272.7,307.34,51.93418013856817,-48.06581986143183,6.066478889371297,5.583338907487761,-0.012903663961424838,97285060,-1.0
942,COST,1568264400000,289.89,292.75,288.68,290.34,2942632,-0.8000000000000114,0.8000000000000114,0.0,46.681004696292185,272.7,307.34,49.62471131639724,-50.37528868360276,5.390659828683567,5.544803091726923,-0.022524193276460935,94342428,-1.0
943,COST,1568350800000,291.9,294.07,289.85,290.2,2306343,2.009999999999991,0.0,2.009999999999991,50.85910550844334,275.69,307.34,51.216429699841996,-48.783570300158004,4.960081820125595,5.427858837406657,-0.009702809065002094,96648771,1.0
944,COST,1568610000000,288.69,291.3769,288.3402,290.57,1508893,-3.2099999999999795,3.2099999999999795,0.0,44.44189342393963,280.34,307.34,30.925925925926013,-69.07407407407399,4.310140852507459,5.204315240426818,-0.011504879301489468,95139878,-1.0
945,COST,1568696400000,291.41,291.7858,288.69,289.56,1776040,2.7200000000000273,0.0,2.7200000000000273,50.5431076861019,287.81,307.34,18.433179723502448,-81.56682027649755,3.9687894863963606,4.957210089620727,-0.015905713899770246,96915918,1.0
946,COST,1568782800000,292.43,293.57,288.8,290.7,1687336,1.0199999999999818,0.0,1.0199999999999818,52.786544301090586,287.81,307.34,23.65591397849468,-76.34408602150532,3.7374881085440848,4.713265693405399,-0.015287739502306663,98603254,1.0
947,COST,1568869200000,287.83,289.76,284.71,289.49,3055125,-4.600000000000023,4.600000000000023,0.0,42.706047696377134,284.71,307.34,13.787008395934622,-86.21299160406538,3.1467250562832874,4.399957565980976,-0.052442717935212046,95548129,-1.0
948,COST,1568955600000,286.36,289.41,286.14,288.75,3473365,-1.4699999999999704,1.4699999999999704,0.0,39.89671457380628,284.71,307.34,7.291206363234797,-92.70879363676521,2.530751439198184,4.026116340624418,-0.04227424749163877,92074764,-1.0
949,COST,1569214800000,287.57,288.13,285.75,286.36,2058102,1.2099999999999795,0.0,1.2099999999999795,43.431051187402076,284.71,307.34,12.63809102960678,-87.36190897039322,2.1158347712346313,3.6440600267464602,-0.03175084175084175,94132866,1.0
950,COST,1569301200000,287.91,292.62,286.4,289.3,2495624,0.34000000000003183,0.0,0.34000000000003183,44.489395804137665,284.71,307.34,14.140521431727999,-85.859478568272,1.7937680396822202,3.2740016293336125,-0.009563452475145229,96628490,1.0
951,COST,1569387600000,288.51,289.68,286.87,288.26,1848371,0.5999999999999659,0.0,0.5999999999999659,46.526475619450345,284.71,307.34,16.79186920017681,-83.20813079982318,1.568858001688909,2.9329729038046723,-0.004760426368622617,98476861,1.0
952,COST,1569474000000,288.26,289.8099,286.6,289.43,1891317,-0.25,0.25,0.0,45.71984718667394,284.71,307.34,15.687140963323076,-84.31285903667693,1.3548246898515686,2.6173432610140517,-0.012470023980815315,96585544,-1.0
953,COST,1569560400000,285.95,289.53,284.4,289.53,1538930,-2.3100000000000023,2.3100000000000023,0.0,38.587397216472446,284.4,298.25,11.191335740072265,-88.80866425992774,0.9874216712913153,2.2913589430695045,-0.00949114967612319,95046614,-1.0
954,COST,1569819600000,288.11,288.62,286.57,287.7,2179096,2.160000000000025,0.0,2.160000000000025,47.43490747880136,284.4,295.74,32.71604938271628,-67.28395061728372,0.8606253271623245,2.0052122198880684,-0.011324251055214396,97225710,1.0
955,COST,1569906000000,283.93,288.68,283.18,288.04,2654476,-4.180000000000007,4.180000000000007,0.0,35.88965787200293,283.18,294.07,6.887052341597805,-93.11294765840219,0.41802847262067644,1.68777547043459,-0.029066785213555435,94571234,-1.0
956,COST,1569992400000,285.11,285.79,282.22,283.23,2506362,1.1800000000000068,0.0,1.1800000000000068,40.598923792272686,282.22,294.07,24.388185654008392,-75.6118143459916,0.16063175213798786,1.3823467267752696,-0.009450022582774498,97077596,1.0
957,COST,1570078800000,289.0,290.86,281.6001,285.39,3958168,3.8899999999999864,0.0,3.8899999999999864,53.571477658158564,281.6001,293.57,61.820900759404886,-38.179099240595114,0.267450483929224,1.1593674782060606,0.009219164687805481,101035764,1.0
958,COST,1570165200000,291.67,291.95,283.32,287.85,4536695,2.670000000000016,0.0,2.670000000000016,60.41757585579075,281.6001,293.57,84.12685151922757,-15.87314848077242,0.5610839577379352,1.0397107741124354,0.014257398198699534,105572459,1.0
959,COST,1570424400000,293.41,295.69,290.5,291.04,2051519,1.740000000000009,0.0,1.740000000000009,64.36833269611077,281.6001,295.69,83.81819601274691,-16.181803987253087,0.9235479733118268,1.0164782139523136,0.019103191969712663,107623978,1.0
960,COST,1570510800000,291.89,295.58,290.45,292.95,2224561,-1.5200000000000387,1.5200000000000387,0.0,58.484492305971976,281.6001,295.69,73.03032668791111,-26.969673312088883,1.0757514274131381,1.0283328566444785,0.011715365151987678,105399417,-1.0
961,COST,1570597200000,296.9,298.57,293.11,293.11,2287230,5.009999999999991,0.0,5.009999999999991,69.19393544048938,281.6001,298.57,90.15904631141011,-9.840953688589893,1.5823979919949807,1.139145883714579,0.02997294109484483,107686647,1.0
962,COST,1570683600000,297.14,299.48,296.26,298.63,1721504,0.2400000000000091,0.0,0.2400000000000091,69.62701278560871,281.6001,299.48,86.91267848254168,-13.087321517458314,1.9804555797215357,1.3074078229159705,0.03913271550970454,109408151,1.0
963,COST,1570770000000,297.6,300.76,297.36,298.07,1891654,0.4600000000000364,0.0,0.4600000000000364,70.54284218880444,281.6001,300.76,83.50722081012964,-16.492779189870348,2.306449922473462,1.507216242827469,0.032938808094130634,111299805,1.0
964,COST,1571029200000,297.52,300.34,297.5,298.0,1313041,-0.08000000000004093,0.08000000000004093,0.0,70.11857424989644,281.6001,300.76,83.08968209646183,-16.91031790353817,2.5291924995870545,1.7116114941793863,0.047863910118691066,109986764,-1.0
965,COST,1571115600000,298.39,299.64,297.23,298.32,1601860,0.8700000000000045,0.0,0.8700000000000045,72.21542801631338,281.6001,300.76,87.63041560759709,-12.369584392402912,2.744284917558332,1.9181461788551757,0.04657851355617115,111588624,1.0
966,COST,1571202000000,298.78,298.97,295.08,296.8,1827669,0.38999999999998636,0.0,0.38999999999998636,73.18857834253274,281.6001,300.76,89.66591683672661,-10.334083163273393,2.912641827164748,2.1170453085170906,0.033840830449827,113416293,1.0
967,COST,1571288400000,302.4,302.61,298.85,298.85,1811818,3.6200000000000045,0.0,3.6200000000000045,80.5024597908488,281.6001,302.61,99.00047120643109,-0.9995287935689187,3.3001278181422435,2.353661810442121,0.036788150992560054,115228111,1.0
968,COST,1571374800000,302.86,304.0,300.9764,302.0,1853976,0.4600000000000364,0.0,0.4600000000000364,81.25230749045684,281.6001,304.0,94.91069156558741,-5.089308434412592,3.6028005709805484,2.603489562549807,0.032207491223884555,117082087,1.0
969,COST,1571634000000,301.08,303.51,300.17,303.0,1395154,-1.7800000000000296,1.7800000000000296,0.0,69.34488534497305,281.6001,304.0,86.96422751887279,-13.035772481127218,3.6568854847885177,2.814168746997549,0.03148446332522514,115686933,-1.0
970,COST,1571720400000,299.97,304.88,299.95,301.61,1970748,-1.1099999999999568,1.1099999999999568,0.0,62.73019431426279,281.6001,304.88,78.90884411015526,-21.091155889844753,3.569038787802924,2.9651427551586247,0.010340181879420873,113716185,-1.0
971,COST,1571806800000,297.32,300.0523,297.18,299.58,1810559,-2.650000000000034,2.650000000000034,0.0,49.67689316466002,283.32,304.88,64.93506493506493,-35.06493506493507,3.2481442099617084,3.0217430461192416,0.0006057750555295005,111905626,-1.0
972,COST,1571893200000,297.05,298.28,294.56,295.05,2117020,-0.2699999999999818,0.2699999999999818,0.0,48.49066651822948,290.45,304.88,45.73804573804588,-54.26195426195412,2.9381767292033487,3.0050297827360635,-0.001848118279569877,109788606,-1.0
973,COST,1571979600000,296.5,297.25,295.11,295.52,1686226,-0.5500000000000114,0.5500000000000114,0.0,45.913735974321526,290.45,304.88,41.92654192654199,-58.07345807345802,2.6179665750000822,2.9276171411888674,-0.0034283409518687247,108102380,-1.0
974,COST,1572238800000,298.94,299.09,295.21,295.7,1672606,2.4399999999999977,0.0,2.4399999999999977,57.480413660848605,293.11,304.88,49.53271028037377,-50.46728971962623,2.5318991712795764,2.8484735472070093,0.0018432253091591466,109774986,1.0
975,COST,1572325200000,295.86,298.94,295.81,298.21,1295287,-3.079999999999984,3.079999999999984,0.0,43.82865528430346,294.56,304.88,12.596899224806322,-87.40310077519368,2.189915887210418,2.7167620152076912,-0.009773077180533996,108479699,-1.0
976,COST,1572411600000,299.84,300.25,295.97,296.92,1264263,3.9799999999999613,0.0,3.9799999999999613,58.51815574241015,294.56,304.88,51.16279069767419,-48.83720930232581,2.2145168368746795,2.616312979541089,-0.00846560846560851,109743962,1.0
977,COST,1572498000000,297.11,299.622,294.55,298.36,2277444,-2.7299999999999613,2.7299999999999613,0.0,48.483286088402174,294.55,304.88,24.782187802517,-75.217812197483,1.9907766482996294,2.491205713292797,-0.018985669946509964,107466518,-1.0
978,COST,1572584400000,296.09,298.415,295.5,297.99,1364483,-1.0200000000000387,1.0200000000000387,0.0,45.145768329064026,294.55,304.88,14.908034849951267,-85.09196515004874,1.711427194022292,2.3352500094386963,-0.01657366812807226,106102035,-1.0
979,COST,1572847200000,296.82,298.22,295.17,297.16,1651608,0.7300000000000182,0.0,0.7300000000000182,48.0963010932175,294.55,304.88,21.974830590512926,-78.02516940948708,1.5312938358959514,2.1744587747301476,-0.010501050105010568,107753643,1.0
980,COST,1572933600000,299.18,299.6925,295.805,297.09,2204542,2.3600000000000136,0.0,2.3600000000000136,56.77013720319367,294.55,304.88,44.8209099709584,-55.1790900290416,1.560975178265437,2.0517620554372056,0.006255885914166592,109958185,1.0
981,COST,1573020000000,301.57,301.65,297.925,299.97,1675008,2.3899999999999864,0.0,2.3899999999999864,63.83270644957963,294.55,304.88,67.95740561471435,-32.04259438528565,1.7570961709677704,1.9928288785433186,0.015216293553273808,111633193,1.0
982,COST,1573106400000,305.21,307.1,302.48,303.93,2399391,3.6399999999999864,0.0,3.6399999999999864,71.90012571918224,294.55,307.1,84.94023904382438,-15.05976095617563,2.18109870176346,2.030482843187347,0.02937605396290044,114032584,1.0
983,COST,1573192800000,302.62,304.29,301.28,302.74,1502221,-2.589999999999975,2.589999999999975,0.0,60.77099483197313,294.55,307.1,64.3027888446214,-35.6972111553786,2.281828904503527,2.080752055450583,0.01231016257442974,112530363,-1.0
984,COST,1573452000000,300.84,302.33,299.7,301.55,1160960,-1.7800000000000296,1.7800000000000296,0.0,54.1272123385731,294.55,307.1,50.119521912350265,-49.880478087649735,2.1927505288211933,2.103151750124705,0.016832285540458125,111369403,-1.0
985,COST,1573538400000,300.5,302.73,298.66,300.83,1540974,-0.339999999999975,0.339999999999975,0.0,52.853705383748206,294.55,307.1,47.41035856573692,-52.58964143426308,2.0708486615051243,2.096691132400789,0.0022011739594451907,109828429,-1.0
986,COST,1573624800000,302.9,304.0,299.52,300.18,1554889,2.3999999999999773,0.0,2.3999999999999773,60.43549352314321,294.55,307.1,66.53386454183233,-33.46613545816766,2.1431950770095796,2.105991921322547,0.019487731816498766,111383318,1.0
987,COST,1573711200000,304.59,305.8884,302.265,304.39,1337458,1.6899999999999977,0.0,1.6899999999999977,65.00764509201763,294.55,307.1,79.99999999999964,-20.000000000000362,2.3102676808719593,2.1468470732324296,0.028707487588233382,112720776,1.0
988,COST,1573797600000,303.66,305.44,301.6,305.31,1707125,-0.92999999999995,0.92999999999995,0.0,60.563673953900924,294.55,307.1,72.58964143426299,-27.41035856573701,2.340649149073272,2.1856074884005983,0.02304426925409353,111013651,-1.0
989,COST,1574056800000,304.54,306.38,302.75,303.11,1242504,0.8799999999999955,0.0,0.8799999999999955,63.30265525803338,294.55,307.1,79.60159362549801,-20.39840637450199,2.4079776594979876,2.2300815226200763,0.01791563607192992,112256155,1.0
990,COST,1574143200000,302.24,304.6446,301.45,304.5,1761832,-2.3000000000000114,2.3000000000000114,0.0,52.3399237974696,294.55,307.1,61.274900398406295,-38.7250996015937,2.249810792628466,2.2340273766217544,0.0022217064031568867,110494323,-1.0
991,COST,1574229600000,300.57,303.17,298.0108,302.44,1979783,-1.670000000000016,1.670000000000016,0.0,45.70818560337576,295.17,307.1,45.264040234702215,-54.73595976529778,1.9670326400369618,2.180628429304796,-0.015202647357557053,108514540,-1.0
992,COST,1574316000000,300.27,301.87,299.52,300.69,1303042,-0.30000000000001137,0.30000000000001137,0.0,44.53846478268406,295.17,307.1,42.7493713327742,-57.25062866722579,1.6991348550716907,2.084329714458175,-0.0077655145066420905,107211498,-1.0
993,COST,1574402400000,299.31,301.94,297.23,301.94,1277594,-0.9599999999999795,0.9599999999999795,0.0,40.693347911249006,295.805,307.1,31.031429836210627,-68.96857016378937,1.3932988713516465,1.9461235458368695,-0.005085759872357265,105933904,-1.0
994,COST,1574661600000,299.05,300.626,297.55,300.29,1613126,-0.2599999999999909,0.2599999999999909,0.0,39.6243269480585,297.23,307.1,18.43971631205666,-81.56028368794334,1.117064993834731,1.780311835436442,-0.004825291181364322,104320778,-1.0
995,COST,1574748000000,301.24,301.35,298.82,299.26,3360612,2.1899999999999977,0.0,2.1899999999999977,51.90408173891199,297.23,307.1,40.628166160080944,-59.371833839919056,1.0626132095256935,1.6367721102542923,-0.0054803565533178,107681390,1.0
996,COST,1574834400000,300.76,302.79,300.57,301.82,1907095,-0.4800000000000182,0.4800000000000182,0.0,49.36491549061254,297.23,306.38,38.5792349726774,-61.42076502732261,0.9695514046165385,1.5033279691267416,-0.01257428017991391,105774295,-1.0
997,COST,1575007200000,299.81,300.89,299.66,300.82,981610,-0.9499999999999886,0.9499999999999886,0.0,44.404203808218064,297.23,306.38,28.196721311475304,-71.8032786885247,0.8098072394642486,1.3646238231942431,-0.012678653757491998,104792685,-1.0
998,COST,1575266400000,297.39,300.2,294.27,299.75,2706951,-2.420000000000016,2.420000000000016,0.0,34.27918670458027,294.27,306.38,25.763831544178373,-74.23616845582163,0.4823745489379121,1.188173968342977,-0.023478032442372232,102085734,-1.0
999,COST,1575352800000,295.67,296.19,292.7,295.13,1962133,-1.7199999999999704,1.7199999999999704,0.0,28.878936713412074,292.7,306.38,21.710526315789664,-78.28947368421034,0.08313384212732444,0.9671659430998465,-0.021737691900476475,100123601,-1.0
1000,COST,1575439200000,296.52,297.16,295.15,296.04,1742589,0.8499999999999659,0.0,0.8499999999999659,34.74114432541772,292.7,306.38,27.923976608187072,-72.07602339181292,-0.1628027098424809,0.741172212511381,-0.013474398642579155,101866190,1.0
1001,COST,1575525600000,293.1,297.13,292.5,297.13,1941250,-3.419999999999959,3.419999999999959,0.0,25.126230746286225,292.5,306.38,4.322766570605353,-95.67723342939465,-0.6264532538662024,0.4676471192358643,-0.023878509341592413,99924940,-1.0
1002,COST,1575612000000,294.945,295.99,294.26,294.98,1462553,1.8449999999999704,0.0,1.8449999999999704,36.12945704266397,292.5,306.38,17.615273775216096,-82.3847262247839,-0.8353936715046189,0.2070389610877676,-0.014583542146938022,101387493,1.0
1003,COST,1575871200000,295.16,297.19,294.545,295.0,1986336,0.21500000000003183,0.0,0.21500000000003183,37.36706504109681,292.5,304.6446,21.902738665744607,-78.09726133425539,-0.9724222759619465,-0.028853286322175285,-0.01300785821768935,103373829,1.0
1004,COST,1575957600000,295.78,296.69,294.545,296.03,1566311,0.6199999999999477,0.0,0.6199999999999477,41.16066384706776,292.5,303.17,30.740393626991263,-69.25960637300874,-1.0192404444005092,-0.22693071793784214,-0.018125082990306907,104940140,1.0
1005,COST,1576044000000,295.3,296.3479,293.05,296.0,1752457,-0.47999999999996135,0.47999999999996135,0.0,39.04793314927102,292.5,302.79,27.210884353741555,-72.78911564625845,-1.0825966681697423,-0.39806390798422225,-0.01815400984173421,103187683,-1.0
1006,COST,1576130400000,297.34,297.76,294.12,295.27,2754453,2.0399999999999636,0.0,2.0399999999999636,51.30491937685672,292.5,302.79,47.035957240038535,-52.96404275996146,-0.9571624085226063,-0.5098836080918991,-0.008238551082352275,105942136,1.0
1007,COST,1576216800000,291.87,295.0,289.1,294.64,5204305,-5.46999999999997,5.46999999999997,0.0,31.62758240760577,289.1,302.79,20.233747260774155,-79.76625273922583,-1.284333146308768,-0.664773515735273,-0.01856148491879339,100737831,-1.0
1525,HD,1514959200000,189.01,189.36,187.81900000000002,188.0,4530468,0.9799999999999898,0.0,0.9799999999999898,65.0774811357154,182.0,191.49,73.86722866174904,-26.13277133825096,0.5895050760069012,0.4951694337646602,0.016292074416603963,17835599,1.0
1526,HD,1515045600000,190.51,190.87,188.47,189.87,4047365,1.5,0.0,1.5,73.14443876795218,182.06,191.49,89.60763520678667,-10.392364793213336,0.654855837246032,0.5271067144609346,0.01708397843147713,21882964,1.0
1527,HD,1515132000000,192.5,192.54,190.51,190.93,4224807,1.990000000000009,0.0,1.990000000000009,80.15991870377789,182.13,192.54,99.61575408261295,-0.38424591738705144,0.8169056088609636,0.5850664933409404,0.02350063802637159,26107771,1.0
1528,HD,1515391200000,192.04,193.72,191.6,191.72,3508451,-0.46000000000000796,0.46000000000000796,0.0,74.93858664069128,183.5,193.72,83.56164383561637,-16.43835616438363,0.9018865236818101,0.6484304994091143,0.020783500770743535,22599320,-1.0
1529,HD,1515477600000,193.1,193.47,191.64,192.7,3012324,1.0600000000000023,0.0,1.0600000000000023,78.6382108335697,184.6,193.72,93.20175438596486,-6.7982456140351335,1.0227292655262374,0.7232902526325391,0.014393780205925522,25611644,1.0
1530,HD,1515564000000,191.8,193.21599999999998,191.65,192.76,3119520,-1.299999999999983,1.299999999999983,0.0,65.04941845659334,186.035,193.72,75.01626545217974,-24.983734547820262,1.0197649324609017,0.7825851885982117,0.00846521899153485,22492124,-1.0
1531,HD,1515650400000,194.68,194.73,191.4,191.68,3899237,2.8799999999999955,0.0,2.8799999999999955,75.75767129463776,187.27,194.73,99.32975871313695,-0.6702412868630441,1.1929053516725219,0.8646492212130737,0.025819369796606706,26391361,1.0
1532,HD,1515736800000,196.42,199.42,194.82,195.5,6748410,1.7399999999999807,0.0,1.7399999999999807,80.0241869435922,187.27,199.42,75.3086419753086,-24.691358024691404,1.4274980218511928,0.9772189813406976,0.0363530839444941,33139771,1.0
1533,HD,1516082400000,196.31,198.9496,195.7,197.86,5692715,-0.10999999999998522,0.10999999999998522,0.0,79.00987457046844,187.81900000000002,199.42,73.19196620980955,-26.80803379019044,1.584734613099215,1.0987221076924012,0.04403552624581186,27447056,-1.0
1534,HD,1516168800000,199.82,199.82,196.8401,197.5,3996052,3.509999999999991,0.0,3.509999999999991,85.68861385965242,187.81900000000002,199.82,100.0,-0.0,1.9263540213490558,1.264248490423732,0.05719274112480832,31443108,1.0
1535,HD,1516255200000,198.33,200.24,197.66,199.78,4474606,-1.4899999999999807,1.4899999999999807,0.0,74.13472474901043,187.81900000000002,200.24,84.62281619837374,-15.37718380162626,2.0665121963512263,1.4247012316092311,0.041047714030759685,26968502,-1.0
1536,HD,1516341600000,201.33,201.33,199.13,199.81,5809640,3.0,0.0,3.0,80.30434462659781,187.81900000000002,201.33,100.0,-0.0,2.359722443284511,1.6117054739442873,0.04587012987012984,32778142,1.0
1537,HD,1516600800000,204.46,204.47,201.51,201.6,4857697,3.1299999999999955,0.0,3.1299999999999955,84.69827118105124,187.81900000000002,204.47,99.93994354693417,-0.060056453065827374,2.780095391138019,1.845383457383034,0.06467402624453245,37635839,1.0
1538,HD,1516687200000,204.9,206.35,204.15099999999998,204.89,3621745,0.4399999999999977,0.0,0.4399999999999977,85.2326404228765,187.81900000000002,206.35,92.17527386541477,-7.824726134585237,3.1063274058326726,2.097572247072962,0.061108234075608614,41257584,1.0
1539,HD,1516773600000,206.22,207.1,204.551,205.2,4370661,1.3199999999999932,0.0,1.3199999999999932,86.82526037976301,188.47,207.1,95.27643585614602,-4.7235641438539755,3.418880922121815,2.3618339820827328,0.07518248175182474,45628245,1.0
1540,HD,1516860000000,205.37,206.83,203.84,206.8,3537694,-0.8499999999999943,0.8499999999999943,0.0,80.38398677690091,190.51,207.1,89.57203134418332,-10.427968655816693,3.5617125303897126,2.601809691744129,0.0549106225600986,42090551,-1.0
1541,HD,1516946400000,207.23,207.3098,204.44,205.6,3778050,1.8599999999999852,0.0,1.8599999999999852,83.47864829330004,191.4,207.3098,99.4984223560321,-0.501577643967906,3.7669690742177693,2.8348415682388572,0.05503512880562056,45868601,1.0
1542,HD,1517205600000,204.92,207.605,204.71,207.23,3632937,-2.3100000000000023,2.3100000000000023,0.0,68.08617849495425,191.4,207.605,83.43103980253005,-16.56896019746995,3.714689011673471,3.0108110569257804,0.043859202282104714,42235664,-1.0
1543,HD,1517292000000,201.81,203.15,191.57,201.47,5979620,-3.109999999999985,3.109999999999985,0.0,52.92616347296546,191.4,207.605,64.23943227398955,-35.76056772601045,3.4019401544364314,3.089036876427911,0.00995896306676003,36256044,-1.0
1544,HD,1517378400000,200.9,205.083,200.23,203.22,4547323,-0.9099999999999966,0.9099999999999966,0.0,49.22565750960592,191.4,207.605,58.62388151805005,-41.37611848194996,3.050804427551924,3.0813903866527137,0.012958200978167689,31708721,-1.0
1545,HD,1517464800000,199.9,202.25,198.28,199.34,3553795,-1.0,1.0,0.0,45.21699998987076,191.57,207.605,51.94886186467112,-48.05113813532888,2.6666076347206342,2.9984338362662983,-0.007102766602096078,28154926,-1.0
1546,HD,1517551200000,193.97,199.3,193.44,199.25,6178952,-5.930000000000007,5.930000000000007,0.0,29.037400596491523,191.57,207.605,14.967259120673566,-85.03274087932643,1.8915864573311865,2.7770643604792764,-0.05130587890051852,21975974,-1.0
1547,HD,1517810400000,183.11,194.295,180.38,190.07,10618526,-10.859999999999985,10.859999999999985,0.0,16.535002507175264,180.38,207.605,10.02754820936646,-89.97245179063354,0.44689405598663257,2.311030299580748,-0.10634455832113221,11357448,-1.0
1548,HD,1517896800000,191.04,191.96,175.42,178.62,11682716,7.929999999999978,0.0,7.929999999999978,38.75325390355425,175.42,207.605,48.53192480969397,-51.46807519030603,-0.08956753699590081,1.8309107322654181,-0.07361070701192907,23040164,1.0
1549,HD,1517983200000,191.29,194.515,189.72,190.73,6016847,0.25,0.0,0.25,39.34063247358246,175.42,207.605,49.30868416964426,-50.69131583035574,-0.4893590847107987,1.3668567688701747,-0.06855918585966803,29057011,1.0
1550,HD,1518069600000,181.22,191.14,180.93,191.14,7241823,-10.069999999999993,10.069999999999993,0.0,27.21159294357288,175.42,207.605,18.020817150846703,-81.9791828491533,-1.5631997019592063,0.7808454747042984,-0.12551271534044295,21815188,-1.0
1551,HD,1518156000000,184.12,186.0,175.79,183.25,9059239,2.9000000000000057,0.0,2.9000000000000057,33.97562711148214,175.42,207.605,27.03122572627005,-72.96877427372995,-2.164227470114696,0.19183088574049945,-0.10150302557095447,30874427,1.0
1552,HD,1518415200000,184.06,187.01,183.41,186.55,6783710,-0.060000000000002274,0.060000000000002274,0.0,33.900421571172316,175.42,207.605,26.84480347988198,-73.15519652011803,-2.6144786957846975,-0.36943103056454013,-0.08795401615380805,24090717,-1.0
1553,HD,1518501600000,183.72,183.99,180.89,183.23,4273771,-0.3400000000000034,0.3400000000000034,0.0,33.41678120338882,175.42,207.605,25.788410750349577,-74.21158924965042,-2.9631235746787183,-0.8881695393873761,-0.08551518168242911,19816946,-1.0
1554,HD,1518588000000,184.69,185.06,181.05,181.88,6767034,0.9699999999999989,0.0,0.9699999999999989,36.403480607849225,175.42,207.605,28.80223706695669,-71.19776293304332,-3.127363823997513,-1.3360083963094036,-0.07608804402201108,26583980,1.0
1555,HD,1518674400000,185.27,187.19,183.255,186.74,5113323,0.5800000000000125,0.0,0.5800000000000125,38.31257557680482,175.42,207.605,30.60431878204139,-69.39568121795861,-3.1753170817723912,-1.7038701334020014,-0.044852296746919595,31697303,1.0
1556,HD,1518760800000,186.97,187.99,184.86,185.06,7619162,1.6999999999999886,0.0,1.6999999999999886,43.99804357624979,175.42,205.083,38.937396756902565,-61.062603243097435,-3.0448250312987,-1.9720611129813412,0.021080225001365305,39316465,1.0
1557,HD,1519106400000,186.71,191.44,186.31,189.9,8922129,-0.2599999999999909,0.2599999999999909,0.0,43.29388818933156,175.42,205.083,38.060883929474485,-61.939116070525515,-2.927970405458751,-2.1632429714768238,-0.0226654103852596,30394336,-1.0
1558,HD,1519192800000,183.06,187.98,182.86,187.21,7527186,-3.6500000000000057,3.6500000000000057,0.0,34.38095746727751,175.42,202.25,28.475587029444693,-71.5244129705553,-3.086880167543029,-2.3479704106900647,-0.04302368132155365,22867150,-1.0
1559,HD,1519279200000,185.47,186.2199,182.91,183.72,5653924,2.4099999999999966,0.0,2.4099999999999966,43.27750228344461,175.42,199.3,42.0854271356784,-57.9145728643216,-2.98820133035872,-2.476016594623796,0.023452157598499168,28521074,1.0
1560,HD,1519365600000,188.35,188.41,185.62,186.2,4315388,2.8799999999999955,0.0,2.8799999999999955,52.21136820428707,175.42,194.515,67.71406127258449,-32.28593872741551,-2.6519064769383363,-2.5111945710867043,0.022974147295242275,32836462,1.0
1561,HD,1519624800000,188.46,189.79,187.8601,189.17,4647963,0.11000000000001364,0.0,0.11000000000001364,52.54079027317119,175.42,194.515,68.29012830583933,-31.70987169416066,-2.349595379323574,-2.4788747327340785,0.02390524828860152,37484425,1.0
1562,HD,1519711200000,184.98,189.25,184.96,188.87,4618805,-3.480000000000018,3.480000000000018,0.0,41.977890294254486,175.79,194.515,49.07877169559413,-50.92122830440587,-2.358479848516282,-2.4547957558905193,0.006858262573481433,32865620,-1.0
1563,HD,1519797600000,182.27,186.6495,182.27,184.41,6419903,-2.7099999999999795,2.7099999999999795,0.0,35.55506640008363,175.79,191.44,41.405750798722146,-58.59424920127786,-2.5510027765569134,-2.4740371600237983,-0.01310303752233466,26445717,-1.0
1564,HD,1519884000000,179.64,184.4,178.25,182.75,6123863,-2.630000000000024,2.630000000000024,0.0,30.354375190452558,175.79,191.44,24.60063897763574,-75.39936102236426,-2.8791617978295108,-2.555062087584941,-0.030388082258325788,20321854,-1.0
1565,HD,1519970400000,178.46,179.185,176.34,177.72,5671038,-1.1799999999999784,1.1799999999999784,0.0,28.217622959508674,176.34,191.44,14.039735099337783,-85.96026490066222,-3.1960819226183617,-2.6832660545916256,-0.045515323313900624,14650816,-1.0
1566,HD,1520229600000,181.74,182.26,177.7,177.86,5748553,3.280000000000001,0.0,3.280000000000001,41.43910940810001,176.34,191.44,35.76158940397356,-64.23841059602644,-3.1497019965414665,-2.7765532429815942,-0.02661882063092491,20399369,1.0
1567,HD,1520316000000,181.64,183.0,179.51,182.75,5306777,-0.10000000000002274,0.10000000000002274,0.0,41.17233631564476,176.34,191.44,35.099337748344276,-64.90066225165573,-3.0852828791181537,-2.838299170208906,-0.007757019556429712,15092592,-1.0
1568,HD,1520402400000,178.58,180.0,176.82,178.82,4799246,-3.059999999999974,3.059999999999974,0.0,33.547062532909024,176.34,191.44,14.83443708609278,-85.16556291390722,-3.2408771323271424,-2.918814762632554,-0.03714886504555981,10293346,-1.0
1569,HD,1520488800000,177.94,179.98,176.73,179.44,4750745,-0.6400000000000148,0.6400000000000148,0.0,32.11183262567177,176.34,191.44,10.596026490066192,-89.4039735099338,-3.3762735231253487,-3.010306514731113,-0.05526944518184229,5542601,-1.0
1570,HD,1520575200000,182.16,182.24,177.92,179.0,4477217,4.219999999999999,0.0,4.219999999999999,48.782869266513174,176.34,191.44,38.543046357615864,-61.456953642384136,-3.1104985913735277,-3.0303449300595964,-0.03342884431709647,10019818,1.0
1571,HD,1520830800000,179.71,183.06,179.55,182.43,4993318,-2.4499999999999886,2.4499999999999886,0.0,41.89163012216567,176.34,189.79,25.055762081784444,-74.94423791821556,-3.060446484030763,-3.03636524085383,-0.028489566439614977,5026500,-1.0
1572,HD,1520917200000,178.35,180.95,177.86,179.59,6128147,-1.3600000000000136,1.3600000000000136,0.0,38.41578495018781,176.34,189.79,14.944237918215558,-85.05576208178444,-3.093880323197567,-3.0478682573225777,-0.0215065562078236,-1101647,-1.0
1573,HD,1521003600000,177.41,179.66,175.89,179.1,4531510,-0.9399999999999977,0.9399999999999977,0.0,36.03152986846804,175.89,189.79,10.93525179856122,-89.06474820143877,-3.1591653337533216,-3.0701276726087268,-0.012413716321531876,-5633157,-1.0
1574,HD,1521090000000,178.07,179.86,176.72,177.69,3936650,0.6599999999999966,0.0,0.6599999999999966,39.09396784375213,175.89,189.79,15.683453237410113,-84.31654676258988,-3.1219993273014097,-3.080502003547264,-0.0021853636669282306,-1696507,1.0
1575,HD,1521176400000,178.96,180.4,177.97,178.43,8410919,0.8900000000000148,0.0,0.8900000000000148,43.316310054587234,175.89,189.25,22.9790419161678,-77.0209580838322,-2.986748290300511,-3.0617512608979136,-0.01529657752833724,6714412,1.0
1576,HD,1521435600000,177.1,179.32,176.0,178.65,4744511,-1.8600000000000136,1.8600000000000136,0.0,37.11218564788374,175.89,186.6495,11.245875737720224,-88.75412426227977,-2.9941696045822823,-3.0482349296347877,-0.02499449460471259,1969901,-1.0
1577,HD,1521522000000,178.16,178.8883,177.16,177.64,4148338,1.0600000000000023,0.0,1.0600000000000023,42.525292975143536,175.89,184.4,26.674500587544124,-73.32549941245587,-2.881760902433598,-3.01494012419455,-0.0023518871094188043,6118239,1.0
1578,HD,1521608400000,178.02,180.14,177.68,178.35,3494433,-0.13999999999998636,0.13999999999998636,0.0,41.97469105411081,175.89,183.06,29.707112970711563,-70.29288702928844,-2.771937276671167,-2.9663395546898736,0.0004495897493537182,2623806,-1.0
1579,HD,1521694800000,175.29,178.56,175.08,177.42,5255092,-2.730000000000018,2.730000000000018,0.0,32.505214681574486,175.08,183.06,2.631578947368168,-97.36842105263183,-2.8709826094622883,-2.947268165644357,-0.03771409749670618,-2631286,-1.0
1580,HD,1521781200000,171.8,177.56,171.56,176.24,6021266,-3.4899999999999807,3.4899999999999807,0.0,24.389145676143144,171.56,183.06,2.0869565217392094,-97.91304347826079,-3.1929618013653567,-2.996406892788557,-0.0440153580769016,-8652552,-1.0
1581,HD,1522040400000,176.38,176.8,173.515,174.11,7323601,4.579999999999984,0.0,4.579999999999984,45.13308355677172,171.56,183.06,41.91304347826081,-58.08695652173918,-3.0449953246091184,-3.0061245791526696,-0.011045696663863236,-1328951,1.0
1582,HD,1522126800000,174.68,178.73,173.6,177.38,4713911,-1.6999999999999886,1.6999999999999886,0.0,40.3875415112976,171.56,183.06,27.130434782608738,-72.86956521739127,-3.0294292508139904,-3.010785513484934,-0.015388084098979737,-6042862,-1.0
1583,HD,1522213200000,174.76,177.53,173.92,175.24,4318636,0.07999999999998408,0.0,0.07999999999998408,40.725952437142126,171.56,183.06,27.82608695652164,-72.17391304347835,-2.976332006753097,-3.003894812138567,-0.018588195653394757,-1724226,1.0
1584,HD,1522299600000,178.24,178.64,175.5,175.7,4423526,3.480000000000018,0.0,3.480000000000018,53.86997266423194,171.56,183.06,58.08695652173918,-41.91304347826081,-2.6241266524164075,-2.9279411801941353,-0.0040232454179705,2699300,1.0
1585,HD,1522645200000,172.9,177.69,170.42,177.15,7229319,-5.340000000000003,5.340000000000003,0.0,38.682435232105234,170.42,180.95,23.551756885090388,-76.44824311490962,-2.742926076528505,-2.8909381594610095,-0.02371541501976282,-4530019,-1.0
1586,HD,1522731600000,173.76,174.9385,172.43,172.78,5283287,0.8599999999999852,0.0,0.8599999999999852,41.73492366499049,170.42,180.4,33.46693386773544,-66.53306613226455,-2.736320431322582,-2.8600146138333242,-0.024696901661428017,753268,1.0
1587,HD,1522818000000,177.44,177.84,170.4204,170.8,4757299,3.680000000000007,0.0,3.680000000000007,53.230465578355194,170.42,180.4,70.34068136272542,-29.659318637274573,-2.4071737033374347,-2.7694464317341465,-0.00325806089203462,5510567,1.0
1588,HD,1522904400000,179.13,180.04,177.31,178.0,3799927,1.6899999999999977,0.0,1.6899999999999977,57.657237168834854,170.42,180.4,87.2745490981963,-12.725450901803686,-1.9873800620282225,-2.613033157792962,0.021906554851959692,9310494,1.0
1589,HD,1522990800000,174.45,178.52,173.35,177.98,5236946,-4.680000000000007,4.680000000000007,0.0,44.26882396429796,170.42,180.14,41.46090534979425,-58.53909465020575,-2.008311322045529,-2.4920887906434754,0.015424912689173231,4073548,-1.0
1590,HD,1523250000000,172.51,175.35,172.37,175.06,5079802,-1.9399999999999977,1.9399999999999977,0.0,39.843578182593,170.42,180.14,21.502057613168763,-78.49794238683124,-2.1562441789957347,-2.4249198683139275,-0.0219412631817667,-1006254,-1.0
1591,HD,1523336400000,173.49,174.1851,172.2352,174.03,4812883,0.9800000000000182,0.0,0.9800000000000182,43.15564440832289,170.42,180.14,31.58436213991792,-68.41563786008209,-2.1695398354459314,-2.3738438617403284,-0.006812457064346189,3806629,1.0
1592,HD,1523422800000,172.86,175.06,171.8,172.0,4228416,-0.6299999999999955,0.6299999999999955,0.0,41.46234686933464,170.42,180.04,25.363825363825626,-74.63617463617437,-2.2053898203485858,-2.34015305346198,-0.01087205310139605,-421787,-1.0
1593,HD,1523509200000,173.36,174.24,172.9,173.31,3396657,0.5,0.0,0.5,43.492727122560424,170.42,180.04,30.56133056133082,-69.43866943866918,-2.168518553447342,-2.3058261534590527,-0.027378815080789876,2974870,1.0
1594,HD,1523595600000,172.8,175.51,172.225,174.49,4311225,-0.5600000000000023,0.5600000000000023,0.0,41.626856119865664,170.42,180.04,24.740124740124976,-75.25987525987502,-2.159515242864387,-2.27656397134012,-0.0005783689994216523,-1336355,-1.0
1595,HD,1523854800000,174.43,175.6,173.32,174.23,3534205,1.6299999999999955,0.0,1.6299999999999955,48.9782221479239,170.42,180.04,41.68399168399187,-58.31600831600814,-1.9980055170068738,-2.2208522804734705,0.003855893186003767,2197850,1.0
1596,HD,1523941200000,174.91,176.24,174.1,175.76,3106493,0.47999999999998977,0.0,0.47999999999998977,51.071923091682955,170.42,180.04,46.67359667359675,-53.32640332640325,-1.8104552443688533,-2.138772873252547,-0.014258340847610462,5304343,1.0
1597,HD,1524027600000,179.85,180.25,174.99,175.0,5858880,4.939999999999998,0.0,4.939999999999998,67.10265941154097,170.42,180.25,95.9308240081383,-4.069175991861701,-1.2492951582718774,-1.960877330256413,0.00401942723161941,11163223,1.0
1598,HD,1524114000000,177.08,179.7,175.77,179.5,5407311,-2.769999999999982,2.769999999999982,0.0,55.3661182290479,170.42,180.25,67.7517802644966,-32.24821973550339,-1.0161216843598595,-1.7719262010771024,0.01507595299512765,5755912,-1.0
1599,HD,1524200400000,177.01,178.89,176.32,177.85,5008614,-0.0700000000000216,0.0700000000000216,0.0,55.085186111116506,170.4204,180.25,67.03833319768852,-32.96166680231148,-0.8274348348602416,-1.5830279278337303,0.026085444322068385,747298,-1.0
1600,HD,1524459600000,177.66,178.38,176.13,177.62,2987719,0.6500000000000057,0.0,0.6500000000000057,57.401082391595004,170.4204,180.25,73.65101326605351,-26.348986733946482,-0.6183734022025931,-1.390097022707503,0.024035967490921628,3735017,1.0
1601,HD,1524546000000,176.26,180.0,175.05,179.3,4435423,-1.4000000000000057,1.4000000000000057,0.0,50.88107131590539,171.8,180.25,52.78106508875723,-47.218934911242776,-0.5591118504420365,-1.2238999882544097,0.01966909637857217,-700406,-1.0
1602,HD,1524632400000,177.39,178.07,174.55,176.08,5587286,1.1299999999999955,0.0,1.1299999999999955,55.58006131741084,171.8,180.25,66.15384615384595,-33.84615384615405,-0.41624349447542386,-1.0623686894986126,0.02324642362713414,4886880,1.0
1603,HD,1524718800000,185.72,185.93,178.08,178.46,8782470,8.330000000000013,0.0,8.330000000000013,75.50880890571864,171.8,185.93,98.5138004246284,-1.4861995753716066,0.3644154452880457,-0.7770118625412809,0.07476851851851851,13669350,1.0
1604,HD,1524805200000,186.46,187.0432,183.87,185.49,4382418,0.7400000000000091,0.0,0.7400000000000091,76.58557216067373,171.8,187.0432,96.17403169938068,-3.825968300619325,1.0308722826495114,-0.4154350335031224,0.06896749412371728,18051768,1.0
1605,HD,1525064400000,184.8,187.8,184.8,186.99,4173189,-1.6599999999999966,1.6599999999999966,0.0,68.7607382890354,171.8,187.8,81.25,-18.75,1.4089384681129786,-0.05056033317990211,0.05654336515922487,13878579,-1.0
1606,HD,1525150800000,184.63,184.73,181.4,184.73,3423884,-0.17000000000001592,0.17000000000001592,0.0,67.94048954041071,172.225,187.8,79.64686998394855,-20.353130016051445,1.6755310300404176,0.2946579394641619,0.02657770364192391,10454695,-1.0
1607,HD,1525237200000,185.91,187.12,183.75,184.49,3866503,1.2800000000000011,0.0,1.2800000000000011,70.95103169767029,172.225,187.8,87.86516853932577,-12.134831460674238,1.9673517323227543,0.6291966980358805,0.04986446803704525,14321198,1.0
1608,HD,1525323600000,183.19,184.9,181.201,184.87,4123873,-2.719999999999999,2.719999999999999,0.0,57.672167197357204,173.32,187.8,68.16298342541431,-31.837016574585693,1.9566980467761255,0.8946969677839296,0.03491328173549513,10197325,-1.0
1609,HD,1525410000000,185.03,186.35,181.84,182.75,3896175,1.8400000000000034,0.0,1.8400000000000034,63.06738637957349,174.1,187.8,79.78102189781016,-20.21897810218983,2.0727591976720134,1.1303094137615464,0.0414837329730946,14093500,1.0
1610,HD,1525669200000,183.56,185.5,182.67,185.4,3582327,-1.4699999999999989,1.4699999999999989,0.0,56.436240888749495,174.55,187.8,67.99999999999993,-32.000000000000064,2.0228553327322345,1.308818597555684,0.041416089867241546,10511173,-1.0
1611,HD,1525755600000,185.04,185.3,182.5,183.45,4168151,1.4799999999999898,0.0,1.4799999999999898,61.178140389399736,174.55,187.8,79.16981132075456,-20.830188679245428,2.0787158439416373,1.462798046832875,0.04312531709791978,14679324,1.0
1612,HD,1525842000000,186.36,186.5,183.57,185.03,3392251,1.3200000000000216,0.0,1.3200000000000216,65.08881523190234,174.55,187.8,89.13207547169813,-10.86792452830187,2.2040483831370636,1.6110481140937132,0.0034460478139135553,18071575,1.0
1613,HD,1525928400000,187.16,187.97,185.88,185.97,3850116,0.799999999999983,0.0,0.799999999999983,67.38623460099052,174.55,187.97,93.96423248882263,-6.0357675111773705,2.340918652672059,1.7570222218093825,0.0037541563874288197,21921691,1.0
1614,HD,1526014800000,190.31,190.8,187.35,187.63,5355073,3.1500000000000057,0.0,3.1500000000000057,74.8928156171143,174.55,190.8,96.98461538461532,-3.0153846153846713,2.6726719684081672,1.9401521711291394,0.02981601731601735,27276764,1.0
1615,HD,1526274000000,191.08,191.65,189.86,191.5,7035919,0.7700000000000102,0.0,0.7700000000000102,76.42337752569497,174.55,191.65,96.6666666666667,-3.3333333333332944,2.96353770631967,2.144829278167246,0.034934734333532,34312683,1.0
1616,HD,1526360400000,187.98,189.69,186.101,189.5,10147044,-3.1000000000000227,3.1000000000000227,0.0,59.55752175130849,178.08,191.65,72.95504789977879,-27.04495210022121,2.9104266329801476,2.297948749129826,0.011134419880587387,24165639,-1.0
1617,HD,1526446800000,186.38,189.28,185.9,189.28,5044785,-1.5999999999999943,1.5999999999999943,0.0,52.63924400152608,181.201,191.65,49.56455163173506,-50.43544836826494,2.708045475343283,2.3799680943725177,0.01741361428025545,19120854,-1.0
1618,HD,1526533200000,185.33,187.18,184.87,186.25,4227660,-1.049999999999983,1.049999999999983,0.0,48.3834965352123,181.201,191.65,39.51574313331433,-60.48425686668567,2.434883043703735,2.390951084238761,0.0016213586985893702,14893194,-1.0
1619,HD,1526619600000,187.42,188.21,185.55,185.75,4697850,2.089999999999975,0.0,2.089999999999975,56.46684408377008,181.201,191.65,59.51765719207567,-40.48234280792433,2.35980416399957,2.384721700190923,0.021028546524297198,19591044,1.0
1620,HD,1526878800000,189.79,190.67,188.0,188.2,4147784,2.3700000000000045,0.0,2.3700000000000045,63.87005237855792,181.201,191.65,82.19925351708287,-17.800746482917134,2.4631084632573277,2.400399052804204,0.025670125378296493,23738828,1.0
1621,HD,1526965200000,186.87,190.78,186.5175,190.06,4585635,-2.9199999999999875,2.9199999999999875,0.0,51.43515324615667,181.201,191.65,54.2539955976649,-45.74600440233511,2.283085244013364,2.376936291046036,0.00273663876368313,19153193,-1.0
1622,HD,1527051600000,186.67,187.315,184.98,187.1,7387362,-0.20000000000001705,0.20000000000001705,0.0,50.65573836129793,181.84,191.65,49.235474006116036,-50.76452599388397,2.1000713844400423,2.321563309724837,-0.002618080786492838,11765831,-1.0
1623,HD,1527138000000,187.15,187.41,184.67,186.79,3941299,0.4800000000000182,0.0,0.4800000000000182,52.64298655869986,182.5,191.65,50.81967213114758,-49.18032786885243,1.971035859031872,2.251457819586244,-0.016604487415269764,15707130,1.0
1624,HD,1527224400000,186.85,187.8302,186.05,186.71,2730436,-0.30000000000001137,0.30000000000001137,0.0,51.1572208717723,182.5,191.65,47.54098360655728,-52.45901639344272,1.823549430205901,2.1658761417101755,-0.022137324680762127,12976694,-1.0
1625,HD,1527570000000,185.0,186.83,184.25,185.55,4725486,-1.8499999999999943,1.8499999999999943,0.0,42.601886041358114,183.57,191.65,17.698019801980255,-82.30198019801975,1.5396587884503106,2.0406326710582023,-0.01585275029258426,8251208,-1.0
1626,HD,1527656400000,187.09,187.8,184.01,184.83,3976000,2.0900000000000034,0.0,2.0900000000000034,52.875034760808965,184.01,191.65,40.314136125654535,-59.68586387434547,1.4663928409904088,1.9257847050446435,0.0038094216117610102,12227208,1.0
1627,HD,1527742800000,186.55,187.36,185.25,187.16,4839948,-0.539999999999992,0.539999999999992,0.0,50.19663183495029,184.01,191.65,33.24607329842952,-66.75392670157048,1.3492078576207405,1.810469335559863,0.00658285220957211,7387260,-1.0
1628,HD,1527829200000,187.35,188.83,186.52,187.21,3706248,0.799999999999983,0.0,0.799999999999983,54.165459661924366,184.01,191.65,43.71727748691095,-56.28272251308905,1.3058309062027433,1.7095416496884388,-0.00037349269021447196,11093508,1.0
1629,HD,1528088400000,191.36,191.54,187.97,188.22,4103328,4.010000000000019,0.0,4.010000000000019,68.6257996065628,184.01,191.54,97.60956175298834,-2.390438247011665,1.576816888214637,1.6829966973936783,0.008272300964223822,15196836,1.0
1630,HD,1528174800000,191.94,192.38,189.7,190.44,4231253,0.5799999999999841,0.0,0.5799999999999841,70.19509565976068,184.01,192.38,94.74313022700123,-5.256869772998775,1.8174211427162277,1.7098815864581882,0.027131160699951806,19428089,1.0
1631,HD,1528261200000,193.59,193.59,191.21,193.07,4134745,1.6500000000000057,0.0,1.6500000000000057,74.39850263480051,184.01,193.59,100.0,-0.0,2.1168288793828083,1.7912710450431124,0.03707076659345376,23562834,1.0
1632,HD,1528347600000,196.17,197.2,193.83,193.83,4378743,2.579999999999984,0.0,2.579999999999984,79.59140811587676,184.01,197.2,92.19105382865807,-7.808946171341935,2.5330783041854374,1.9396324968715775,0.048196633716270254,27941577,1.0
1633,HD,1528434000000,198.33,198.5,195.01,195.87,4006213,2.160000000000025,0.0,2.160000000000025,82.93512896702171,184.01,198.5,98.82677708764675,-1.17322291235326,3.0026262762575584,2.152231252748774,0.0614396574792615,31947790,1.0
1634,HD,1528693200000,199.64,200.52,198.34,198.91,4242950,1.3099999999999739,0.0,1.3099999999999739,84.6904075480992,184.01,200.52,94.66989703210162,-5.330102967898382,3.440780943427228,2.409941190884465,0.07913513513513504,36190740,1.0
1635,HD,1528779600000,201.31,201.34,199.51,199.84,4616661,1.670000000000016,0.0,1.670000000000016,86.70233176694269,184.01,201.34,99.8268897864974,-0.17311021350260308,3.8780631167767297,2.703565576062918,0.07600620022449078,40807401,1.0
1636,HD,1528866000000,200.31,201.58,199.6588,201.3,5128112,-1.0,1.0,0.0,79.4851838322413,184.01,201.58,92.77177006260666,-7.228229937393333,4.096700776555622,2.982192616161459,0.07376038595550782,35679289,-1.0
1637,HD,1528952400000,199.67,201.0,198.16,200.26,4305893,-0.6400000000000148,0.6400000000000148,0.0,74.88218146353998,184.01,201.58,89.12919749573123,-10.870802504268768,4.17026026056061,3.21980614504129,0.0657592740859354,31373396,-1.0
1638,HD,1529038800000,200.54,201.6,198.5,198.95,7820898,0.8700000000000045,0.0,0.8700000000000045,76.97372049144019,184.01,201.6,93.9738487777146,-6.026151222285401,4.249765594138211,3.4257980348606747,0.04797240802675584,39194294,1.0
1639,HD,1529298000000,200.69,200.91,198.11,198.94,3405347,0.15000000000000568,0.0,0.15000000000000568,77.34894602384004,184.01,201.6,94.82660602615124,-5.173393973848758,4.275590520910839,3.5957565320707072,0.045587162654996405,42599641,1.0
1640,HD,1529384400000,199.21,199.9,198.1,198.21,5501146,-1.4799999999999898,1.4799999999999898,0.0,65.24483001459598,185.25,201.6,85.38226299694198,-14.617737003058027,4.1290413465044935,3.7024134949574643,0.02903042512526466,37098495,-1.0
1641,HD,1529470800000,199.08,200.13,198.12,200.0,3389588,-0.12999999999999545,0.12999999999999545,0.0,64.22619081210333,186.52,201.6,83.28912466843512,-16.710875331564885,3.9567988207350595,3.753290560112984,0.014834072488148164,33708907,-1.0
1642,HD,1529557200000,200.31,200.94,198.61,199.21,4695068,1.2299999999999898,0.0,1.2299999999999898,69.43571633033504,187.97,201.6,90.53558327219375,-9.464416727806254,3.8748748781353015,3.7776074237174475,0.009983361064891838,38403975,1.0
1643,HD,1529643600000,197.41,201.2,197.17,200.79,7067329,-2.9000000000000057,2.9000000000000057,0.0,49.73324923894753,189.7,201.6,64.78991596638659,-35.21008403361341,3.535200394910504,3.7291260179560592,-0.011170106191144002,31336646,-1.0
1644,HD,1529902800000,196.38,197.84,195.06,197.41,5127170,-1.0300000000000011,1.0300000000000011,0.0,44.55245371571239,191.21,201.6,49.75938402309908,-50.240615976900926,3.1466238700043334,3.6126255883657143,-0.02448959316477084,26209476,-1.0
1645,HD,1529989200000,196.36,197.33,195.6,196.58,3270629,-0.01999999999998181,0.01999999999998181,0.0,44.44871294133514,193.83,201.6,32.56113256113265,-67.43886743886735,2.804729161018656,3.451046302896303,-0.019719434875942188,22938847,-1.0
1646,HD,1530075600000,195.02,197.99,195.01,196.66,3771722,-1.3400000000000034,1.3400000000000034,0.0,37.66802950732445,195.01,201.6,0.15174506828557394,-99.84825493171444,2.398008626552496,3.2404387676275417,-0.023288425902739385,19167125,-1.0
1647,HD,1530162000000,195.21,196.01,193.51,195.0,2994073,0.18999999999999773,0.0,0.18999999999999773,39.1858336921975,193.51,201.6,21.01359703337474,-78.98640296662526,2.067181490100694,3.0057873121221723,-0.026578238755360473,22161198,1.0
1648,HD,1530248400000,195.1,198.83,194.99,195.86,4106627,-0.11000000000001364,0.11000000000001364,0.0,38.558623080623626,193.51,201.6,19.653893695920925,-80.34610630407909,1.7756540911162801,2.759760667920994,-0.02785390403109278,18054571,-1.0
1649,HD,1530507600000,194.02,194.18,192.12,193.82,3822776,-1.079999999999984,1.079999999999984,0.0,32.6400836349402,192.12,201.6,20.04219409282709,-79.95780590717291,1.4408621587583639,2.495980966088468,-0.02605290899051249,14231795,-1.0
1650,HD,1530594000000,193.62,195.71,193.41,194.44,1608418,-0.4000000000000057,0.4000000000000057,0.0,30.63082490123172,192.12,201.6,15.822784810126599,-84.1772151898734,1.1302325590095847,2.2228312846726914,-0.02742616033755274,12623377,-1.0
1651,HD,1530766800000,194.41,194.74,193.13,194.49,3040575,0.789999999999992,0.0,0.789999999999992,39.164854756446076,192.12,201.6,24.156118143459857,-75.84388185654014,0.9370003862135547,1.965665104980864,-0.029454345764065692,15663952,1.0
1652,HD,1530853200000,194.48,195.35,192.95,194.58,2552568,0.06999999999999318,0.0,0.06999999999999318,39.920525500140975,192.12,201.2,25.991189427312655,-74.00881057268734,0.7805135404854298,1.7286347920817775,-0.014842206575148231,18216520,1.0
1653,HD,1531112400000,196.08,196.71,195.03,195.7,2575076,1.6000000000000227,0.0,1.6000000000000227,54.74590432205287,192.12,201.2,43.61233480176228,-56.38766519823773,0.7766483490725307,1.538237503479928,-0.0015276504735715069,20791596,1.0
1654,HD,1531198800000,197.61,197.76,196.38,196.56,2842359,1.5300000000000011,0.0,1.5300000000000011,64.43041753784159,192.12,201.2,60.4625550660795,-39.537444933920504,0.8868187495329778,1.4079537526905381,0.006365858627011667,23633955,1.0
1655,HD,1531285200000,196.95,197.76,195.9506,197.22,3309295,-0.660000000000025,0.660000000000025,0.0,58.22811369143468,192.12,201.2,53.19383259911886,-46.80616740088114,0.910379533465175,1.3084389088454655,0.009896420879909718,20324660,-1.0
1656,HD,1531371600000,197.95,198.48,197.0,198.2,2709206,1.0,0.0,1.0,64.24536811315397,192.12,201.2,64.20704845814971,-35.79295154185028,0.9982351408582986,1.2463981552480323,0.014036166180011245,23033866,1.0
1657,HD,1531458000000,198.69,199.93,198.46,198.46,2311624,0.7400000000000091,0.0,0.7400000000000091,68.16141330666908,192.12,199.93,84.12291933418683,-15.877080665813173,1.1147225651492079,1.2200630372282675,0.018400820092260295,25345490,1.0
1658,HD,1531717200000,198.88,199.22,197.89,199.14,2530462,0.18999999999999773,0.0,0.18999999999999773,69.16203716276142,192.12,199.93,86.55569782330332,-13.444302176696684,1.2084407364347385,1.2177385770695617,0.025048964024327214,27875952,1.0
1659,HD,1531803600000,201.1,201.43,198.63,198.63,4662847,2.219999999999999,0.0,2.219999999999999,78.33965131931888,192.12,201.43,96.45542427497301,-3.544575725026986,1.4451873740516703,1.2632283364659835,0.03863237268877184,32538799,1.0
1660,HD,1531890000000,200.97,201.92,200.19,201.02,3787846,-0.12999999999999545,0.12999999999999545,0.0,76.79540130759614,192.12,201.92,90.30612244897969,-9.693877551020309,1.603832940467555,1.331349257266298,0.033743120209865696,28750953,-1.0
1661,HD,1531976400000,202.63,203.23,200.5463,200.89,3691097,1.6599999999999966,0.0,1.6599999999999966,82.01799962000906,192.12,203.23,94.59945994599465,-5.400540054005357,1.8422710206179715,1.4335336099366327,0.04190662278897572,32442050,1.0
1662,HD,1532062800000,202.45,203.76,201.82,202.08,3568417,-0.18000000000000682,0.18000000000000682,0.0,79.77166956662117,192.12,203.76,88.74570446735392,-11.254295532646081,1.9937280371923976,1.5455724953877858,0.032486740106079104,28873633,-1.0
1663,HD,1532322000000,202.23,203.39,201.9,202.46,2264267,-0.21999999999999886,0.21999999999999886,0.0,76.8051131600075,192.95,203.76,85.84643848288621,-14.153561517113792,2.072120631819729,1.6508821226741748,0.023379383634431372,26609366,-1.0
1664,HD,1532408400000,201.99,204.25,201.35,203.53,5058216,-0.23999999999998067,0.23999999999998067,0.0,73.37062053106669,192.95,204.25,80.0000000000001,-19.999999999999897,2.0907802253856573,1.7388617432164715,0.025590251332825664,21551150,-1.0
1665,HD,1532494800000,201.0,202.29,199.07,201.4,4380559,-0.9900000000000091,0.9900000000000091,0.0,60.495106889118986,192.95,204.25,71.23893805309737,-28.76106194690263,2.00259914631053,1.791609223835283,0.015407931295781774,17170591,-1.0
1666,HD,1532581200000,199.4,202.12,198.91,201.53,4280024,-1.5999999999999943,1.5999999999999943,0.0,45.57940441123503,195.03,204.25,47.39696312364431,-52.60303687635569,1.7830552005102902,1.7898984191702842,0.0035734058080427733,12890567,-1.0
1667,HD,1532667600000,197.14,200.49,196.68,200.21,3871568,-2.2600000000000193,2.2600000000000193,0.0,32.513841808650255,195.9506,204.25,14.331156469142096,-85.66884353085791,1.4104442343489154,1.7140075822060103,-0.008748994368463436,9018999,-1.0
1668,HD,1532926800000,197.28,197.57,196.4,196.53,2331224,0.14000000000001478,0.0,0.14000000000001478,33.868822871856025,195.9506,204.25,16.018025399426392,-83.98197460057361,1.1136071658898175,1.5939274989427719,-0.018995524614619508,11350223,1.0
1669,HD,1533013200000,197.52,198.03,196.87,197.69,2795866,0.2400000000000091,0.0,0.2400000000000091,36.394871838177956,196.4,204.25,14.267515923566949,-85.73248407643305,0.8874970419014687,1.4526414075345113,-0.01716674130467233,14146089,1.0
1670,HD,1533099600000,196.3,197.74,195.6,196.86,3086996,-1.2199999999999989,1.2199999999999989,0.0,29.733319992970095,195.6,204.25,8.092485549133139,-91.90751445086686,0.6029098127901591,1.282695088585641,-0.031239204461333436,11059093,-1.0
1671,HD,1533186000000,195.66,195.8444,193.55,195.1,3543511,-0.6400000000000148,0.6400000000000148,0.0,26.76770723354855,193.55,204.25,19.719626168224185,-80.28037383177582,0.3220179326358448,1.0905596573956817,-0.03353914546801673,7515582,-1.0
1672,HD,1533272400000,195.64,196.4,195.25,196.03,2309318,-0.020000000000010232,0.020000000000010232,0.0,26.67178461175955,193.55,204.25,19.532710280373617,-80.46728971962638,0.09668080006528612,0.8917838859296026,-0.03258665875488309,5206264,-1.0
1673,HD,1533531600000,195.69,196.06,195.11,195.62,2515673,0.05000000000001137,0.0,0.05000000000001137,27.4220287427229,193.55,204.25,19.999999999999893,-80.0000000000001,-0.07697856459833474,0.6980313958240151,-0.03118966285459679,7721937,1.0
1674,HD,1533618000000,197.05,197.2,195.64,196.35,3052464,1.3600000000000136,0.0,1.3600000000000136,45.06271557405804,193.55,204.25,32.710280373831814,-67.28971962616819,-0.1036695469820188,0.5376912072628083,-0.01965174129353231,10774401,1.0
1675,HD,1533704400000,198.02,198.91,197.3,197.44,2177400,0.9699999999999989,0.0,0.9699999999999989,54.22000848942641,193.55,204.25,41.775700934579476,-58.224299065420524,-0.04602118427905566,0.42094872895443547,-0.00692076228686056,12951801,1.0
1676,HD,1533790800000,198.08,199.74,198.04,199.0,2465988,0.060000000000002274,0.0,0.060000000000002274,54.75823719853018,193.55,204.25,42.3364485981309,-57.66355140186911,0.00445567957348203,0.33765011907824477,0.004768185046160278,15417789,1.0
1677,HD,1533877200000,196.3,197.93,195.6438,197.34,2873006,-1.7800000000000011,1.7800000000000011,0.0,39.04480467993808,193.55,204.25,25.700934579439277,-74.29906542056072,-0.09804162728894994,0.25051176980480583,-0.0049675587996755866,12544783,-1.0
1678,HD,1534136400000,194.14,197.59,194.0,196.3,5294354,-2.160000000000025,2.160000000000025,0.0,27.853457396836546,193.55,202.29,6.750572082379591,-93.24942791762041,-0.3495357717666252,0.13050226149051958,-0.017112191170514546,7250429,-1.0
1679,HD,1534222800000,193.1,195.98,191.27,195.17,11487974,-1.039999999999992,1.039999999999992,0.0,24.027385480246423,191.27,202.12,16.86635944700447,-83.13364055299553,-0.6255547988656929,-0.020709150580722965,-0.016301579215486584,-4237545,-1.0
1680,HD,1534309200000,193.99,194.18,191.09,191.75,6049299,0.8900000000000148,0.0,0.8900000000000148,33.10132919454949,191.09,200.49,30.85106382978728,-69.14893617021272,-0.763683181516086,-0.16930395676779564,-0.008535214146989656,1811754,1.0
1681,HD,1534395600000,195.39,196.09,193.72,194.02,5690109,1.3999999999999773,0.0,1.3999999999999773,45.0200418415996,191.09,199.74,49.71098265895931,-50.28901734104069,-0.751519780599665,-0.28574712153416953,-0.0012778572888979545,7501863,1.0
1682,HD,1534482000000,195.56,195.98,194.82,195.6,3885804,0.17000000000001592,0.0,0.17000000000001592,46.359031622052825,191.09,199.74,51.67630057803464,-48.323699421965365,-0.7198644909636585,-0.3725705954200674,-0.0006643160100158196,11387667,1.0
1683,HD,1534741200000,197.93,198.44,195.4,195.84,2956741,2.3700000000000045,0.0,2.3700000000000045,61.4581788672444,191.09,199.74,79.0751445086705,-20.92485549132949,-0.4978002364225347,-0.3976165236205609,0.004465871606191385,14344408,1.0
1684,HD,1534827600000,200.23,200.74,198.41,198.83,4124597,2.299999999999983,0.0,2.299999999999983,70.69503880307403,191.09,200.74,94.71502590673555,-5.284974093264446,-0.13466983327722915,-0.34502718555189454,0.011160488839511151,18469005,1.0
1685,HD,1534914000000,198.97,203.55,198.6505,200.8,5007014,-1.259999999999991,1.259999999999991,0.0,61.394423743785154,191.09,203.55,63.242375601926085,-36.757624398073915,0.050856060020521454,-0.26585053643741136,0.004493134087237394,13461991,-1.0
1686,HD,1535000400000,200.16,201.41,199.14,199.39,3595033,1.1899999999999977,0.0,1.1899999999999977,66.23516322369233,191.09,203.55,72.79293739967886,-27.20706260032113,0.2905601959453463,-0.15456838996085978,0.019663779928680514,17057024,1.0
1687,HD,1535086800000,201.3,202.5,200.0,200.35,3054321,1.1400000000000148,0.0,1.1400000000000148,70.34533929840819,191.09,203.55,81.94221508828251,-18.057784911717484,0.5659914109789952,-0.010456429772888746,0.03688060162769147,20111345,1.0
1688,HD,1535346000000,201.98,202.95,201.19,202.83,2521349,0.6799999999999784,0.0,0.6799999999999784,72.63778467662385,191.09,203.55,87.39967897271251,-12.600321027287483,0.8295800021712978,0.15755085661594861,0.04598653547384779,22632694,1.0
1689,HD,1535432400000,201.97,202.4196,200.63,202.3,3516441,-0.009999999999990905,0.009999999999990905,0.0,72.5426282078289,191.09,203.55,87.31942215088273,-12.680577849117267,1.0258436526277421,0.33120941581830743,0.04113614103819785,19116253,-1.0
1690,HD,1535518800000,201.68,201.99,200.7125,201.11,2488194,-0.28999999999999204,0.28999999999999204,0.0,69.49625549576947,191.09,203.55,84.99197431781698,-15.008025682183012,1.1447870594144263,0.4939249445375313,0.0321920262040023,16628059,-1.0
1691,HD,1535605200000,199.26,201.44,199.1,201.0,2825582,-2.420000000000016,2.420000000000016,0.0,49.4865005801677,191.09,203.55,65.56982343499183,-34.43017656500817,1.0318820684877323,0.6015163693275716,0.018920024544896608,13802477,-1.0
1692,HD,1535691600000,200.77,200.91,199.29,199.38,4023306,1.5100000000000193,0.0,1.5100000000000193,58.15978783667707,191.09,203.55,77.68860353130017,-22.311396468699833,1.0521201425176514,0.6916371239655876,0.014348507047946324,17825783,1.0
1693,HD,1536037200000,205.08,205.92,200.5,200.69,4612762,4.310000000000002,0.0,4.310000000000002,73.27339876137361,191.09,205.92,94.33580579905613,-5.66419420094387,1.3998036088044614,0.8332704209333625,0.02422214453378624,22438545,1.0
1694,HD,1536123600000,204.15,206.67,203.15,204.83,3667119,-0.9300000000000068,0.9300000000000068,0.0,67.22732072715186,193.72,206.67,80.54054054054066,-19.459459459459335,1.5820650211933867,0.9830293409853674,0.026034075488767128,18771426,-1.0
1695,HD,1536210000000,205.89,207.09,203.8,204.59,3490531,1.7399999999999807,0.0,1.7399999999999807,72.18250332504779,194.82,207.09,90.22004889975537,-9.779951100244629,1.8456365174447456,1.1555507762772432,0.028627098321342803,22261957,1.0
1696,HD,1536296400000,206.23,207.2299,205.43,205.45,3672696,0.3400000000000034,0.0,0.3400000000000034,73.09953651304495,195.4,207.2299,91.54768848426447,-8.452311515735538,2.0582279940709896,1.3360862198359926,0.02449080973671136,25934653,1.0
1697,HD,1536555600000,210.69,211.62,208.13,208.13,5586552,4.460000000000008,0.0,4.460000000000008,82.05398556353663,198.41,211.62,92.95987887963659,-7.040121120363409,2.5571159499762075,1.5802921658640359,0.043123081493217086,31521205,1.0
1698,HD,1536642000000,213.85,214.66,211.5,213.0,5969470,3.1599999999999966,0.0,3.1599999999999966,85.8929594103479,198.6505,214.66,94.94050407570504,-5.059495924294963,3.1709212949710945,1.898417991685448,0.058820616923305424,37490675,1.0
1699,HD,1536728400000,211.98,215.43,210.91,214.03,5660075,-1.8700000000000045,1.8700000000000045,0.0,74.94590053673141,199.1,215.43,78.87323943661964,-21.12676056338037,3.4665133403606774,2.212037061420494,0.05107100357001171,31830600,-1.0
1700,HD,1536814800000,209.45,211.44,208.7,211.44,4701094,-2.530000000000001,2.530000000000001,0.0,62.50906929415077,199.1,215.43,63.38028169014076,-36.61971830985924,3.4567748484246295,2.460984618821321,0.05113921509585473,27129506,-1.0
1701,HD,1536901200000,209.07,210.53,207.55,210.19,3622393,-0.37999999999999545,0.37999999999999545,0.0,60.76162937568692,199.1,215.43,61.05327617881194,-38.94672382118805,3.3794381498838675,2.644675325033831,0.04134083777456787,23507113,-1.0
1702,HD,1537160400000,208.4,210.035,208.26,209.08,3074720,-0.6699999999999875,0.6699999999999875,0.0,57.4919485470438,199.1,215.43,56.95039804041644,-43.04960195958356,3.226887328684228,2.7611177257639103,0.016188804369026588,20432393,-1.0
1703,HD,1537246800000,211.02,211.73,208.16,208.63,4338462,2.6200000000000045,0.0,2.6200000000000045,65.79657252796443,199.1,215.43,72.99448867115743,-27.00551132884258,3.279596582945601,2.864813497200249,0.03365172667156502,24770855,1.0
1704,HD,1537333200000,211.68,212.67,210.66,212.0,2579094,0.6599999999999966,0.0,0.6599999999999966,67.63447308059378,199.1,215.43,77.03612982241276,-22.963870177587246,3.336168240343767,2.9590844458289527,0.028121812618388642,27349949,1.0
1705,HD,1537419600000,211.06,212.61,211.005,211.66,4020776,-0.6200000000000045,0.6200000000000045,0.0,63.91200904557125,199.29,215.43,72.92441140024782,-27.07558859975217,3.293013076198406,3.025870171902844,0.0234204528924018,23329173,-1.0
1706,HD,1537506000000,212.39,212.66,210.51,211.3,9749205,1.329999999999984,0.0,1.329999999999984,68.23881093596876,200.5,215.43,79.63831212324168,-20.36168787675833,3.3277716701959434,3.0862504715614643,0.008068726565095607,33078378,1.0
1707,HD,1537765200000,207.99,211.84,207.96,211.52,4623688,-4.399999999999977,4.399999999999977,0.0,46.8135938590637,203.15,215.43,39.413680781758984,-60.586319218241016,2.9660838019146922,3.06221713763211,-0.02740238484919333,28454690,-1.0
1708,HD,1537851600000,207.46,209.3,206.8,208.84,4443309,-0.5300000000000011,0.5300000000000011,0.0,44.85616053583936,203.8,215.43,31.47033533963885,-68.52966466036115,2.606629398633487,2.9710995898323858,-0.02132276629870733,24011381,-1.0
1709,HD,1537938000000,207.52,209.14,207.23,208.58,2965845,0.060000000000002274,0.0,0.060000000000002274,45.1557107913014,205.43,215.43,20.900000000000034,-79.09999999999997,2.300086723519996,2.836897016569908,-0.009214609692050457,26977226,1.0
1710,HD,1538024400000,206.84,207.83,205.6713,207.5,3218841,-0.6800000000000068,0.6800000000000068,0.0,42.16077930266663,205.6713,215.43,11.975980407226379,-88.02401959277361,1.9794611432141949,2.6654098418987657,-0.010666284019706262,23758385,-1.0
1711,HD,1538110800000,207.15,208.85,206.35,206.44,3966222,0.3100000000000023,0.0,0.3100000000000023,44.11064194381607,205.6713,215.43,15.152633035137905,-84.84736696486209,1.730430143642593,2.4784139022475316,-0.005998080614203483,27724607,1.0
1712,HD,1538370000000,207.6,209.79,207.37,208.52,3670701,0.44999999999998863,0.0,0.44999999999998863,47.09777293420142,205.6713,215.43,19.763902978880292,-80.23609702111972,1.5514978139065363,2.2930306845793327,-0.0162069945976685,31395308,1.0
1713,HD,1538456400000,204.75,208.04,204.67,207.49,4428039,-2.8499999999999943,2.8499999999999943,0.0,33.869258229496126,204.67,212.67,1.0000000000001563,-98.99999999999984,1.1662773897888883,2.067680025621244,-0.03273809523809523,26967269,-1.0
1714,HD,1538542800000,203.74,206.46,203.65,206.1622,4162453,-1.009999999999991,1.009999999999991,0.0,30.380073568390713,203.65,212.67,0.9977827050998181,-99.00221729490019,0.7706058177408011,1.8082651840451553,-0.034682080924855474,22804816,-1.0
1715,HD,1538629200000,198.85,203.76,198.27,203.65,5996170,-4.890000000000015,4.890000000000015,0.0,19.282678913534284,198.27,212.67,4.027777777777673,-95.97222222222233,0.06173947545451597,1.4589600423270275,-0.06375064739394509,16808646,-1.0
1716,HD,1538715600000,196.38,199.7,194.57,199.07,5016586,-2.469999999999999,2.469999999999999,0.0,15.898043515965625,194.57,212.67,10.000000000000016,-89.99999999999999,-0.6913807315862357,1.0288918875443749,-0.055819991345737785,11792060,-1.0
1717,HD,1538974800000,198.41,198.66,195.06,196.24,3731816,2.030000000000001,0.0,2.030000000000001,27.899401341451295,194.57,212.67,21.215469613259692,-78.7845303867403,-1.111615889711743,0.6007903320931511,-0.04362286705871021,15523876,1.0
1718,HD,1539061200000,195.75,199.18,195.58,197.95,4466758,-2.6599999999999966,2.6599999999999966,0.0,22.94823910398219,194.57,212.66,6.522940851299097,-93.4770591487009,-1.6403856798434049,0.15255512970583981,-0.056717424826522755,11057118,-1.0
1719,HD,1539147600000,193.7,199.24,193.35,199.11,6157921,-2.0500000000000114,2.0500000000000114,0.0,19.820397424149164,193.35,212.66,1.812532366649375,-98.18746763335062,-2.1995028972458783,-0.317856475684504,-0.06352736414620008,4899197,-1.0
1720,HD,1539234000000,189.74,196.67,188.47,193.71,5831416,-3.9599999999999795,3.9599999999999795,0.0,15.202048499145448,188.47,211.84,5.43431750106979,-94.56568249893022,-2.9283895417542567,-0.8399630888984547,-0.08404537774559495,-932219,-1.0
1721,HD,1539320400000,192.47,193.59,190.16,192.75,5450229,2.7299999999999898,0.0,2.7299999999999898,28.4616035865982,188.47,209.79,18.761726078799256,-81.23827392120074,-3.2483048564690478,-1.3216314424125735,-0.07288053949903661,4518010,1.0
1722,HD,1539579600000,191.17,193.29,190.7021,192.36,3642768,-1.3000000000000114,1.3000000000000114,0.0,26.209774199707454,188.47,209.79,12.664165103189445,-87.33583489681055,-3.5656367335519974,-1.7704325006404587,-0.06632478632478633,875242,-1.0
1723,HD,1539666000000,193.58,194.08,190.61,191.83,4057412,2.410000000000025,0.0,2.410000000000025,36.89032516083003,188.47,209.79,23.968105065666112,-76.03189493433389,-3.5813738393692915,-2.1326207683862255,-0.04986747815843717,4932654,1.0
1724,HD,1539752400000,185.17,190.67,183.98,189.64,8985667,-8.410000000000025,8.410000000000025,0.0,23.30696134213656,183.98,209.79,4.610616040294451,-95.38938395970555,-4.223773246657316,-2.550851264040444,-0.06879557455368368,-4053013,-1.0
1725,HD,1539838800000,180.44,185.4,179.53,184.26,9261963,-4.72999999999999,4.72999999999999,0.0,18.811858728717368,179.53,209.79,3.0072703238598706,-96.99272967614013,-5.056265369262206,-3.0519340850847967,-0.08116916182910683,-13314976,-1.0
1726,HD,1539925200000,179.85,180.99,178.57,180.34,7004297,-0.5900000000000034,0.5900000000000034,0.0,18.303777147268264,178.57,208.04,4.3434000678656295,-95.65659993213437,-5.697947052623334,-3.5811366785925043,-0.09354367219394188,-20319273,-1.0
1727,HD,1540184400000,178.75,181.4,177.56,180.82,4866716,-1.0999999999999943,1.0999999999999943,0.0,17.298690394342188,177.56,206.46,4.117647058823521,-95.88235294117648,-6.22350452456493,-4.10961024778699,-0.08684546615581101,-25185989,-1.0
1728,HD,1540270800000,178.53,179.49,175.44,175.77,7004926,-0.21999999999999886,0.21999999999999886,0.0,17.082226627716807,175.44,203.76,10.911016949152557,-89.08898305084745,-6.581892803932078,-4.604066759016008,-0.07831698502839435,-32190915,-1.0
1729,HD,1540357200000,176.97,182.3693,176.31,178.58,6791655,-1.5600000000000023,1.5600000000000023,0.0,15.495747573294253,175.44,199.7,6.306677658697452,-93.69332234130255,-6.912118454201902,-5.065677098053187,-0.06730262464425008,-38982570,-1.0
1730,HD,1540443600000,179.07,180.5,176.8262,177.52,5227977,2.0999999999999943,0.0,2.0999999999999943,26.149142115138204,175.44,199.24,15.252100840336109,-84.74789915966389,-6.924550312802381,-5.437451741003026,-0.06962123967371536,-33754593,1.0
1731,HD,1540530000000,172.23,177.34,170.91,176.88,9472382,-6.840000000000003,6.840000000000003,0.0,17.742678416862077,170.91,199.24,4.659371690787125,-95.34062830921287,-7.401019121323969,-5.830165217067216,-0.0990741225087618,-43226975,-1.0
1732,HD,1540789200000,173.2,175.99,170.95,173.74,5918379,0.9699999999999989,0.0,0.9699999999999989,21.853503053149737,170.91,199.24,8.083303918107982,-91.91669608189203,-7.612599880994367,-6.186652149852646,-0.10527947101973356,-37308596,1.0
1733,HD,1540875600000,176.24,176.43,172.64,173.16,5657107,3.0400000000000205,0.0,3.0400000000000205,33.814491068927296,170.91,196.67,20.69099378881993,-79.30900621118006,-7.44910789292544,-6.439143298467206,-0.048225954528271164,-31651489,1.0
1734,HD,1540962000000,175.88,178.85,175.59,177.98,6339454,-0.36000000000001364,0.36000000000001364,0.0,33.12178639746257,170.91,194.08,21.450151057401794,-78.54984894259822,-7.26484370842482,-6.60428338045873,-0.025271558412768846,-37990943,-1.0
1735,HD,1541048400000,180.46,180.86,175.9,176.84,5225343,4.5800000000000125,0.0,4.5800000000000125,48.58352821131076,170.91,194.08,41.21709106603368,-58.78290893396632,-6.6723308257637655,-6.617892869519738,0.0033917153183209425,-32765600,1.0
1736,HD,1541134800000,179.93,183.01,177.39,182.47,4730020,-0.5300000000000011,0.5300000000000011,0.0,47.128681160575496,170.91,194.08,38.92965041001297,-61.07034958998704,-6.174352573589886,-6.529184810333768,0.006601398601398634,-37495620,-1.0
1737,HD,1541397600000,182.19,182.41,179.3,181.02,3885319,2.259999999999991,0.0,2.259999999999991,53.9181891062772,170.91,190.67,57.08502024291501,-42.914979757084986,-5.533550784249286,-6.330058005116872,0.020500756175432677,-33610301,1.0
1738,HD,1541484000000,182.01,182.65,180.05,181.93,3339037,-0.18000000000000682,0.18000000000000682,0.0,53.28930561955023,170.91,185.4,76.60455486542435,-23.395445134575656,-4.982796666419574,-6.060605737377413,0.028479403288693028,-36949338,-1.0
1739,HD,1541570400000,187.23,187.68,182.06,183.79,4673834,5.219999999999999,0.0,5.219999999999999,66.40204961976016,170.91,187.68,97.31663685152047,-2.6833631484795277,-4.078099897627254,-5.664104569427382,0.04556877198860776,-32275504,1.0
1740,HD,1541656800000,188.0,188.69,185.72,187.13,4054004,0.7700000000000102,0.0,0.7700000000000102,67.93415311248259,170.91,188.69,96.11923509561306,-3.8807649043869388,-3.26139331485723,-5.183562318513352,0.09156360680485398,-28221500,1.0
1741,HD,1541743200000,185.99,188.48,184.96,188.32,4761172,-2.009999999999991,2.009999999999991,0.0,59.73021068632633,170.91,188.69,84.81439820022504,-15.185601799774965,-2.7446984869963558,-4.695789552209953,0.07384526558891458,-32982672,-1.0
1742,HD,1542002400000,179.43,186.95,179.02,185.23,7590396,-6.560000000000002,6.560000000000002,0.0,41.05823116393094,170.91,188.69,47.91901012373459,-52.08098987626541,-2.8319068207515556,-4.323013005918273,0.01810031774852483,-40573068,-1.0
1743,HD,1542088800000,179.0,181.62,172.85,177.3,14274029,-0.4300000000000068,0.4300000000000068,0.0,40.10989915648279,170.91,188.69,45.50056242969631,-54.4994375703037,-2.902261989604881,-4.038862802655595,0.017739367750739143,-54847097,-1.0
1744,HD,1542175200000,179.9,182.9,179.15,182.61,7561076,0.9000000000000057,0.0,0.9000000000000057,43.27409645946184,170.91,188.69,50.562429696288014,-49.437570303711986,-2.8525144791354933,-3.8015931379515746,-0.003103180760279267,-47286021,1.0
1745,HD,1542261600000,177.36,179.67,173.61,179.01,8663136,-2.539999999999992,2.539999999999992,0.0,36.92180333458681,170.95,188.69,36.13303269447589,-63.86696730552411,-2.9836523015968055,-3.6380049706806212,-0.014283332407047156,-55949157,-1.0
1746,HD,1542348000000,177.02,177.605,173.51,173.99,6834880,-0.3400000000000034,0.3400000000000034,0.0,36.10325931580743,172.64,188.69,27.289719626168353,-72.71028037383165,-3.07951638084333,-3.5263072527131634,-0.028376969098194094,-62784037,-1.0
1747,HD,1542607200000,173.59,178.88,172.3,176.71,6203443,-3.430000000000007,3.430000000000007,0.0,28.697544519944373,172.3,188.69,7.870652837095749,-92.12934716290425,-3.393147591917426,-3.4996753205540156,-0.04626119443986587,-68987480,-1.0
1748,HD,1542693600000,169.05,172.0,167.0,169.25,8661014,-4.539999999999992,4.539999999999992,0.0,21.851839115434743,167.0,188.69,9.451360073766766,-90.54863992623324,-3.9623669401398445,-3.5922136444711814,-0.09709982374619441,-77648494,-1.0
1749,HD,1542780000000,169.3,170.93,169.145,170.0,5752238,0.25,0.0,0.25,23.0186250731838,167.0,188.69,10.603964960811489,-89.39603503918852,-4.34323831627961,-3.742418578832867,-0.09946808510638294,-71896256,1.0
1750,HD,1542952800000,168.85,170.33,168.47,169.39,2710983,-0.45000000000001705,0.45000000000001705,0.0,22.326300712007267,167.0,188.69,8.529276164130911,-91.4707238358691,-4.628043658197157,-3.9195435947057256,-0.09215549223076513,-74607239,-1.0
1751,HD,1543212000000,169.82,172.39,168.87,170.2,6140476,0.9699999999999989,0.0,0.9699999999999989,27.73236497833865,167.0,188.69,13.001383125864423,-86.99861687413558,-4.721061591526933,-4.079847194069967,-0.053558490776347445,-68466763,1.0
1752,HD,1543298400000,173.22,173.38,168.82,169.11,7084186,3.4000000000000057,0.0,3.4000000000000057,43.606536617883414,167.0,188.69,28.676809589672658,-71.32319041032734,-4.468912548935151,-4.157660265043004,-0.03229050279329615,-61382577,1.0
1753,HD,1543384800000,177.43,177.65,170.62,172.91,7133627,4.210000000000008,0.0,4.210000000000008,57.077138047844336,167.0,188.69,48.0866758875058,-51.913324112494195,-3.8845916485618943,-4.1030465417467825,-0.013729849916620296,-54248950,1.0
1754,HD,1543471200000,175.66,177.27,174.92,176.8,4329330,-1.7700000000000102,1.7700000000000102,0.0,51.15002578396925,167.0,188.48,40.316573556797024,-59.68342644320298,-3.5237181028425653,-3.9871808539659392,-0.009585024808299591,-58578280,-1.0
1755,HD,1543557600000,180.32,180.37,175.11,175.75,8942386,4.659999999999997,0.0,4.659999999999997,62.864663970243726,167.0,186.95,66.76691729323309,-33.233082706766915,-2.8290881978752225,-3.7555623227477963,0.018641961360298165,-49635894,1.0
1756,HD,1543816800000,181.74,183.5,179.35,183.29,7609902,1.420000000000016,0.0,1.420000000000016,65.7523235094384,167.0,183.5,89.33333333333339,-10.666666666666611,-2.1393458149276228,-3.432319021183762,0.0469497090846247,-42025992,1.0
1757,HD,1543903200000,175.3,182.23,174.55,181.06,7059563,-6.439999999999998,6.439999999999998,0.0,46.735096113852165,167.0,183.5,50.30303030303037,-49.69696969696963,-2.0883015426540794,-3.1635155254778256,0.036971310263235635,-49085555,-1.0
1758,HD,1544076000000,175.96,176.04,170.4551,173.5,7571194,0.6599999999999966,0.0,0.6599999999999966,48.49657789863486,167.0,183.5,54.303030303030354,-45.696969696969646,-1.9718617108686942,-2.9251847625559995,0.03933845245126988,-41514361,1.0
1759,HD,1544162400000,172.79,178.36,172.24,175.35,6226078,-3.170000000000016,3.170000000000016,0.0,40.98508761037433,167.0,183.5,35.090909090909044,-64.90909090909096,-2.1110400555633078,-2.7623558211574615,0.023334320402724318,-47740439,-1.0
1760,HD,1544421600000,171.69,173.985,167.73,173.39,5373771,-1.0999999999999943,1.0999999999999943,0.0,38.59181822142914,167.0,183.5,28.42424242424241,-71.57575757575759,-2.28377476902304,-2.6666396107305776,0.011011659404075003,-53114210,-1.0
1761,HD,1544508000000,172.21,175.6,171.24,174.3,5229405,0.5200000000000102,0.0,0.5200000000000102,40.4873605866383,167.0,183.5,31.575757575757624,-68.42424242424238,-2.3516008293543393,-2.60363185445533,-0.0058307354808913026,-47884805,1.0
1762,HD,1544594400000,174.21,176.87,172.81,173.75,5912831,2.0,0.0,2.0,47.65762599979965,167.73,183.5,41.09067850348772,-58.90932149651228,-2.218397876303385,-2.526585058824941,-0.018148002028969157,-41971974,1.0
1763,HD,1544680800000,173.87,174.91,172.07,174.31,6102173,-0.3400000000000034,0.3400000000000034,0.0,46.55732658421063,167.73,183.5,38.93468611287261,-61.065313887127395,-2.115878207838904,-2.444443688627734,-0.01019014004326535,-48074147,-1.0
1764,HD,1544767200000,172.29,175.14,171.95,172.98,4265183,-1.5800000000000125,1.5800000000000125,0.0,41.42864976311983,167.73,183.5,28.915662650602403,-71.0843373493976,-2.1374838437190533,-2.383051719645998,-0.04453194321206744,-52339330,-1.0
1765,HD,1545026400000,167.97,171.99,166.93,171.51,5631716,-4.319999999999993,4.319999999999993,0.0,30.74414703912356,166.93,183.5,6.276403138201523,-93.72359686179847,-2.474667929542335,-2.4013749616252653,-0.07576758005942563,-57971046,-1.0
1766,HD,1545112800000,170.04,171.95,168.5,168.9,4462210,2.069999999999993,0.0,2.069999999999993,39.38694244645543,166.93,183.5,18.76885938442961,-81.23114061557038,-2.545513946741096,-2.4302027586484316,-0.03000570450656026,-53508836,1.0
1767,HD,1545199200000,167.56,174.95,166.77,170.92,6996948,-2.4799999999999898,2.4799999999999898,0.0,33.59184378576717,166.77,183.5,4.722056186491288,-95.27794381350871,-2.769846136936877,-2.4981314343061207,-0.04773812230052288,-60505784,-1.0
1768,HD,1545285600000,164.16,167.31,162.23,166.28,7675587,-3.4000000000000057,3.4000000000000057,0.0,27.249589235389195,162.23,183.5,9.073812881993446,-90.92618711800655,-3.1852648478274546,-2.6355581170103877,-0.04994501996643319,-68181371,-1.0
1769,HD,1545372000000,160.48,167.96,160.17,162.81,13034103,-3.680000000000007,3.680000000000007,0.0,22.050327514450174,160.17,183.5,1.3287612516073815,-98.67123874839262,-3.7679972861976694,-2.862045950847844,-0.06529209621993137,-81215474,-1.0
1770,HD,1545631200000,158.14,161.4,158.09,160.16,4547363,-2.3400000000000034,2.3400000000000034,0.0,19.34255866519176,158.09,182.23,0.20712510356248126,-99.79287489643752,-4.368280566150958,-3.163292873908467,-0.08170257244062495,-85762837,-1.0
1771,HD,1545804000000,168.28,168.28,159.44,159.46,6141459,10.140000000000015,0.0,10.140000000000015,50.02628861759777,158.09,178.36,50.271336951159306,-49.72866304884069,-3.9799181167239794,-3.3266179224715695,-0.03403937776247057,-79621378,1.0
1772,HD,1545890400000,170.32,170.46,163.3627,166.44,5069251,2.039999999999992,0.0,2.039999999999992,54.08131146884694,158.09,178.36,60.335471139615116,-39.664528860384884,-3.467555307717788,-3.354805399520813,-0.020417553344452832,-74552127,1.0
1773,HD,1545976800000,170.22,173.12,168.6,171.22,4551989,-0.09999999999999432,0.09999999999999432,0.0,53.83423692484461,158.09,176.87,64.58998935037272,-35.410010649627296,-3.034592362667013,-3.290762792150053,-0.012014626501828274,-79104116,-1.0
1774,HD,1546236000000,171.82,173.24,170.65,171.47,4206020,1.5999999999999943,0.0,1.5999999999999943,57.42512644897139,158.09,176.87,73.1096911608093,-26.890308839190684,-2.5331588034850085,-3.1392419944170444,0.02292075965946294,-74898096,1.0
1775,HD,1546408800000,172.41,173.18,169.05,169.71,4242898,0.5900000000000034,0.0,0.5900000000000034,58.78900306078301,158.09,176.87,76.25133120340783,-23.74866879659216,-2.0643643192520074,-2.9242664593840373,0.013937896965420027,-70655198,1.0
1776,HD,1546495200000,168.61,171.84,168.21,171.84,4810468,-3.799999999999983,3.799999999999983,0.0,47.484466349188025,158.09,175.14,61.70087976539601,-38.29912023460398,-1.9766835768648718,-2.7347498828802044,0.006266412031511237,-75465666,-1.0
1777,HD,1546581600000,173.62,174.74,169.5203,170.18,4762627,5.009999999999991,0.0,5.009999999999991,59.36972147284135,158.09,175.14,91.08504398826989,-8.914956011730107,-1.4858034107749631,-2.484960588459156,0.057626705653021526,-70703039,1.0
1778,HD,1546840800000,177.04,178.18,173.83,173.83,4928789,3.4199999999999875,0.0,3.4199999999999875,65.51674969468561,158.09,178.18,94.32553509208554,-5.674464907914458,-0.81145794293721,-2.150260059354767,0.10319042871385853,-65774250,1.0
1779,HD,1546927200000,177.89,179.59,175.61,178.57,4722367,0.8499999999999943,0.0,0.8499999999999943,66.95065031364146,158.09,179.59,92.09302325581388,-7.906976744186125,-0.2060709474932878,-1.7614222369824712,0.124889338560769,-61051883,1.0
1780,HD,1547013600000,179.73,181.27,177.0999,177.87,4922046,1.8400000000000034,0.0,1.8400000000000034,70.06025874020222,158.09,181.27,93.35634167385669,-6.6436583261433135,0.4173641165701838,-1.3256649662719402,0.06804135963869729,-56129837,1.0
1781,HD,1547100000000,179.06,179.24,176.34,178.03,3605294,-0.6699999999999875,0.6699999999999875,0.0,67.39596816115994,158.09,181.27,90.46591889559963,-9.534081104400377,0.8476068121982507,-0.891010610577902,0.05131517144199149,-59735131,-1.0
1782,HD,1547186400000,179.41,180.26,177.12,177.93,3285063,0.3499999999999943,0.0,0.3499999999999943,68.12656842362242,158.09,181.27,91.97584124245033,-8.024158757549667,1.2029524362417021,-0.47221800121398105,0.05398895546939264,-56450068,1.0
1783,HD,1547445600000,178.81,179.23,176.9007,177.59,3871399,-0.5999999999999943,0.5999999999999943,0.0,65.23508401951176,158.09,181.27,89.3874029335634,-10.612597066436615,1.4197850199399227,-0.09381739698320021,0.040682109184029924,-60321467,-1.0
1784,HD,1547532000000,176.47,177.8212,175.2,176.08,5016065,-2.3400000000000034,2.3400000000000034,0.0,54.77370428079973,159.44,181.27,78.0119102153,-21.988089784699994,1.3868215455289032,0.20231039151922056,0.02354851806739755,-65337532,-1.0
1785,HD,1547618400000,177.04,177.93,175.86,177.09,4075410,0.5699999999999932,0.0,0.5699999999999932,56.72426338617712,163.3627,181.27,76.37834849474788,-23.62165150525212,1.3906613128908418,0.4399805757935449,0.04999703457683391,-61262122,1.0
1786,HD,1547704800000,174.87,175.46,172.0,174.01,6499188,-2.1699999999999875,2.1699999999999875,0.0,47.689379888437976,168.21,181.27,50.99540581929553,-49.00459418070447,1.204716272459848,0.5929277151268055,0.007199631378873361,-67761310,-1.0
1787,HD,1547791200000,179.58,180.04,176.18,176.98,6371422,4.710000000000008,0.0,4.710000000000008,62.60585921958333,168.21,181.27,87.05972434915775,-12.940275650842247,1.4210303713733197,0.7585482463761084,0.014347040216900142,-61389888,1.0
1788,HD,1548136800000,177.11,178.6048,175.3626,177.49,6272715,-2.469999999999999,2.469999999999999,0.0,53.39317542151052,168.21,181.27,68.14701378254215,-31.852986217457858,1.377276114251515,0.8822938199511898,-0.0043847321378378545,-67662603,-1.0
1789,HD,1548223200000,176.89,178.06,174.53,176.59,4910402,-0.22000000000002728,0.22000000000002728,0.0,52.59772741204551,168.21,181.27,66.46248085758022,-33.53751914241978,1.3097504015366042,0.9677851362682727,-0.01580147999777448,-72573005,-1.0
1790,HD,1548309600000,177.29,177.53,175.3,177.0,3860309,0.4000000000000057,0.0,0.4000000000000057,54.034356356969305,169.5203,181.27,66.12679472667377,-33.87320527332623,1.2738285422547335,1.0289938174655648,-0.009884954763766385,-68712696,1.0
1791,HD,1548396000000,180.4,180.87,178.61,179.78,4502516,3.1100000000000136,0.0,3.1100000000000136,63.86037164453441,172.0,181.27,90.61488673139154,-9.385113268608453,1.4792592388153594,1.1190469017355238,0.005518087063151489,-64210180,1.0
1792,HD,1548655200000,179.83,179.99,177.41,178.97,4091373,-0.5699999999999932,0.5699999999999932,0.0,61.09829604325184,172.0,181.27,84.46601941747576,-15.53398058252423,1.5778814741551912,1.2108138162194573,0.00570437894972331,-68301553,-1.0
1793,HD,1548741600000,179.69,180.15,178.09,178.96,3686877,-0.14000000000001478,0.14000000000001478,0.0,60.35844675235192,172.0,181.27,82.95577130528575,-17.04422869471425,1.6259999608296027,1.2938510451414864,0.01824672748909162,-71988430,-1.0
1794,HD,1548828000000,182.18,184.2,179.78,180.47,5197765,2.490000000000009,0.0,2.490000000000009,68.24875748469415,172.0,184.2,83.4426229508198,-16.557377049180193,1.8438021943602223,1.4038412749852338,0.029032986895616952,-66790665,1.0
1795,HD,1548914400000,183.53,184.67,181.06,181.5,5138001,1.3499999999999943,0.0,1.3499999999999943,71.76453019176523,172.0,184.67,91.002367797948,-8.997632202051992,2.1011252867578776,1.5432980773397627,0.049522502430376925,-61652664,1.0
1796,HD,1549000800000,184.37,185.15,182.83,184.03,4513184,0.8400000000000034,0.0,0.8400000000000034,73.84387669161363,172.0,185.15,94.06844106463878,-5.931558935361222,2.3457957974564465,1.7037976213630996,0.026673348925269957,-57139480,1.0
1797,HD,1549260000000,186.43,186.43,183.84,184.3,3050201,2.0600000000000023,0.0,2.0600000000000023,78.3544892638367,172.0,186.43,100.0,-0.0,2.6750869861654962,1.898055494323579,0.052622663881203735,-54089279,1.0
1798,HD,1549346400000,186.39,186.99,184.69,186.89,4135159,-0.040000000000020464,0.040000000000020464,0.0,78.0529166059252,172.0,186.99,95.99733155436942,-4.00266844563057,2.899402453259256,2.0983248861107144,0.05370569280343718,-58224438,-1.0
1799,HD,1549432800000,184.72,186.69,184.06,186.69,3072472,-1.6699999999999875,1.6699999999999875,0.0,65.8446747873405,172.0,186.99,84.85657104736485,-15.14342895263515,2.9088871929955076,2.2604373474876733,0.041908737097411164,-61296910,-1.0
1800,HD,1549519200000,184.07,184.9231,182.45,183.74,2793487,-0.6500000000000057,0.6500000000000057,0.0,61.52305391443669,174.53,186.99,76.56500802568206,-23.434991974317928,2.8313166934478886,2.3746132166797165,0.020343680709534295,-64090397,-1.0
1801,HD,1549605600000,184.54,184.58,182.72,183.05,2792477,0.46999999999999886,0.0,0.46999999999999886,63.520640530524304,174.53,186.99,80.33707865168526,-19.66292134831473,2.7757692457209657,2.4548444224879664,0.026191402991714297,-61297920,1.0
1802,HD,1549864800000,182.92,185.42,182.75,185.0,3729222,-1.6200000000000045,1.6200000000000045,0.0,52.649723463449966,174.53,186.99,67.33547351524865,-32.664526484751356,2.571385698427008,2.4781526776757747,0.01797540208136228,-65027142,-1.0
1803,HD,1549951200000,185.52,186.4,183.52,183.84,3773229,2.6000000000000227,0.0,2.6000000000000227,64.04484017222397,175.3,186.99,87.42514970059881,-12.574850299401191,2.5893600052320096,2.500394143187022,0.018333516302557973,-61253913,1.0
1804,HD,1550037600000,188.41,188.68,185.92,186.3,4147029,2.8899999999999864,0.0,2.8899999999999864,72.52503465977287,177.41,188.68,97.60425909494224,-2.395740905057764,2.8044753737166275,2.561210389292943,0.02658965836647953,-57106884,1.0
1805,HD,1550124000000,187.71,188.93,186.0025,187.5,2600831,-0.6999999999999886,0.6999999999999886,0.0,68.04008531269,177.41,188.93,89.40972222222224,-10.590277777777759,2.885212766425326,2.62601086471942,0.018115745511742665,-59707715,-1.0
1806,HD,1550210400000,192.39,192.62,189.05,189.87,4997891,4.679999999999978,0.0,4.679999999999978,78.36235672050341,178.09,192.62,98.4170681348932,-1.582931865106801,3.2889219741521742,2.758593086605971,0.03196910368502914,-54709824,1.0
1807,HD,1550556000000,192.33,193.19,191.28,191.71,3828464,-0.05999999999997385,0.05999999999997385,0.0,77.98974162240833,179.78,193.19,93.58687546607021,-6.413124533929794,3.562951444887318,2.919464758262241,0.031868662481892907,-58538288,-1.0
1808,HD,1550642400000,191.85,192.4,191.11,192.39,3970075,-0.4800000000000182,0.4800000000000182,0.0,74.71050666609933,181.06,193.19,88.95300906842536,-11.04699093157464,3.6987528656101745,3.075322379731828,0.03859896058899959,-62508363,-1.0
1809,HD,1550728800000,191.82,192.37,190.61,191.85,3094240,-0.030000000000001137,0.030000000000001137,0.0,74.4846516354805,182.45,193.19,87.24394785847296,-12.756052141527032,3.760605797906834,3.21237906336683,0.042103547563427046,-65602603,-1.0
1810,HD,1550815200000,192.39,192.54,191.62,191.69,3321635,0.5699999999999932,0.0,0.5699999999999932,76.07057383577227,182.45,193.19,92.5512104283053,-7.448789571694698,3.8116802514344954,3.3322393009803633,0.04253820309959888,-62280968,1.0
1811,HD,1551074400000,189.98,193.4199,189.96,192.75,6190665,-2.4099999999999966,2.4099999999999966,0.0,58.37085008221958,182.45,193.4199,68.64237595602498,-31.35762404397502,3.616007185109794,3.3889928778062495,0.03859610758801657,-68471633,-1.0
1812,HD,1551160800000,188.3,188.47,182.8,185.59,13635082,-1.6799999999999784,1.6799999999999784,0.0,49.16888998438506,182.45,193.4199,53.32774227659331,-46.67225772340669,3.287476923069704,3.3686896868589407,0.014984907287624027,-82106715,-1.0
1813,HD,1551247200000,183.67,188.5,183.21,187.9,8766217,-4.630000000000024,4.630000000000024,0.0,32.750718795223065,182.45,193.4199,11.121341124349321,-88.87865887565067,2.623272564825612,3.219606262452275,-0.025157900323762084,-90872932,-1.0
1814,HD,1551333600000,185.14,185.19,183.11,183.6,8060552,1.4699999999999989,0.0,1.4699999999999989,40.080436778440266,182.72,193.4199,22.6170338040541,-77.3829661959459,2.190254648075637,3.013735939576948,-0.01369133237440745,-82812380,1.0
1815,HD,1551420000000,185.17,186.56,182.861,185.82,5481417,0.030000000000001137,0.0,0.030000000000001137,40.23383024743145,182.75,193.4199,22.680624935566264,-77.31937506443374,1.8284285919542924,2.776674470052417,-0.03752793804251775,-77330963,1.0
1816,HD,1551679200000,183.81,186.24,182.1025,186.2,5046772,-1.3599999999999852,1.3599999999999852,0.0,35.48247313565865,182.1025,193.4199,15.08738756251442,-84.91261243748558,1.4156198175983832,2.5044635395616104,-0.04429886133208549,-82377735,-1.0
1817,HD,1551765600000,184.0,185.12,183.25,184.24,3690994,0.18999999999999773,0.0,0.18999999999999773,36.68772227845129,182.1025,193.4199,16.76621838938276,-83.23378161061724,1.091218415266411,2.2218145147025705,-0.04091738337242634,-78686741,1.0
1818,HD,1551852000000,184.45,184.97,183.84,184.53,4460878,0.44999999999998863,0.0,0.44999999999998863,39.76289848574404,182.1025,193.4199,20.742396663544564,-79.25760333645545,0.8605196708134883,1.949555545924754,-0.03842143676363263,-74225863,1.0
1819,HD,1551938400000,182.51,184.62,181.58,184.39,4122194,-1.9399999999999977,1.9399999999999977,0.0,32.02521092270668,181.58,193.4199,7.854796070912578,-92.14520392908742,0.5152084645307866,1.6626861296459607,-0.051354020479234874,-78348057,-1.0
1820,HD,1552024800000,181.23,181.91,179.52,181.49,3867055,-1.2800000000000011,1.2800000000000011,0.0,27.892983035918277,179.52,193.4199,12.302246778753654,-87.69775322124634,0.13668591300864819,1.3574860863184983,-0.04605747973470897,-82215112,-1.0
1821,HD,1552280400000,182.44,183.1966,181.2,182.0,3866236,1.210000000000008,0.0,1.210000000000008,36.789226821647596,179.52,193.4199,21.00734537658535,-78.99265462341465,-0.06491079731029004,1.0730067095927407,-0.031120552310143434,-78348876,1.0
1822,HD,1552366800000,184.0,184.27,182.33,183.43,3776971,1.5600000000000023,0.0,1.5600000000000023,46.59149733108946,179.52,193.4199,32.23044770106252,-67.76955229893748,-0.09767276924779367,0.8388708138246338,0.0017967006043448919,-74571905,1.0
1823,HD,1552453200000,181.14,183.78,181.0801,183.24,4528250,-2.8600000000000136,2.8600000000000136,0.0,35.08293964979737,179.52,193.4199,11.654760106187641,-88.34523989381236,-0.35037604902854014,0.6010214412539989,-0.02160527168629145,-79100155,-1.0
1824,HD,1552539600000,181.61,181.74,180.5,181.28,4393038,0.4700000000000273,0.0,0.4700000000000273,37.987453988563196,179.52,193.4199,15.03607939625467,-84.96392060374532,-0.5068771822022882,0.37944171656274145,-0.019225576497272634,-74707117,1.0
1825,HD,1552626000000,182.23,182.49,179.57,182.3,8059489,0.6199999999999761,0.0,0.6199999999999761,41.94133387258689,179.52,188.5,30.1781737193762,-69.8218262806238,-0.5742569625283807,0.188701980744517,-0.008595832653283342,-66647628,1.0
1826,HD,1552885200000,183.42,183.48,182.33,182.53,4395846,1.1899999999999977,0.0,1.1899999999999977,49.125077844431424,179.52,188.5,43.42984409799534,-56.57015590200466,-0.5255743748943473,0.0458467096167441,-0.0031521739130435655,-62251782,1.0
1827,HD,1552971600000,184.13,185.82,183.48,184.19,4437087,0.710000000000008,0.0,0.710000000000008,53.1184945901652,179.52,186.56,65.4829545454544,-34.517045454545595,-0.42480511820369316,-0.04828365594734338,-0.0017348875033884603,-57814695,1.0
1828,HD,1553058000000,186.1,187.12,183.43,184.3,4772648,1.9699999999999989,0.0,1.9699999999999989,62.53383285442424,179.52,187.12,86.57894736842091,-13.421052631579093,-0.1838627647522344,-0.0753994777083216,0.019670155059996697,-53042047,1.0
1829,HD,1553144400000,189.97,190.0,185.5,185.5,4756126,3.8700000000000045,0.0,3.8700000000000045,74.25405533421011,179.52,190.0,99.71374045801525,-0.28625954198474396,0.31572298526421605,0.0028250148861859513,0.04822601114605751,-48285921,1.0
1830,HD,1553230800000,188.75,192.05,188.67,189.31,5173724,-1.2199999999999989,1.2199999999999989,0.0,66.66808182654886,179.52,192.05,73.66320830007972,-26.33679169992028,0.6062164021135175,0.12350329233165229,0.034586713440035055,-53459645,-1.0
1831,HD,1553490000000,189.68,191.71,188.51,188.75,3845892,0.9300000000000068,0.0,0.9300000000000068,69.41630572942738,179.52,192.05,81.08539505187547,-18.914604948124534,0.901090544633746,0.2790207427920711,0.03086956521739137,-49613753,1.0
1832,HD,1553576400000,189.34,192.19,188.74,190.69,4143254,-0.3400000000000034,0.3400000000000034,0.0,67.08312195952502,179.52,192.19,77.50591949486979,-22.494080505130206,1.0947259492339185,0.44216178408044066,0.045268852821022554,-53757007,-1.0
1833,HD,1553662800000,189.25,191.61,188.39,189.65,4298373,-0.09000000000000341,0.09000000000000341,0.0,66.40144831886822,179.52,192.19,76.79558011049723,-23.204419889502766,1.226779602989268,0.5990853478622062,0.042068168052419974,-58055380,-1.0
1834,HD,1553749200000,190.06,191.3999,189.16,189.91,3326131,0.8100000000000023,0.0,0.8100000000000023,69.60849885181416,179.57,192.19,83.12202852614902,-16.877971473850987,1.3808754331043929,0.7554433649106437,0.04296767820885705,-54729249,1.0
1835,HD,1553835600000,191.89,192.04,190.14,190.85,4674122,1.829999999999984,0.0,1.829999999999984,75.66398135141688,179.57,192.19,97.62282091917582,-2.377179080824178,1.6318522181429103,0.9307251355570972,0.046178170319485234,-50055127,1.0
1836,HD,1554094800000,195.64,195.9,192.85,192.99,5381379,3.75,0.0,3.75,83.45740546879668,179.57,195.9,98.40783833435384,-1.5921616656461672,2.1090351441020516,1.1663871372660883,0.06251018302286426,-44673748,1.0
1837,HD,1554181200000,194.31,195.5,194.015,195.5,2717818,-1.329999999999984,1.329999999999984,0.0,73.78734980847345,179.57,195.9,90.26331904470298,-9.736680955297013,2.3527649562466593,1.4036627010622027,0.044116066630843775,-47391566,-1.0
1838,HD,1554267600000,198.61,198.785,194.11,194.98,4581479,4.300000000000011,0.0,4.300000000000011,81.69819314277981,179.57,198.785,99.08925318761393,-0.9107468123860677,2.859929168535615,1.6949159945568855,0.04548086539980001,-42810087,1.0
1839,HD,1554354000000,200.45,200.49,198.02,199.0,3138816,1.839999999999975,0.0,1.839999999999975,84.07164321911867,182.33,200.49,99.77973568281926,-0.22026431718072947,3.371468888492302,2.030226573343969,0.061986754966887325,-39671271,1.0
1840,HD,1554440400000,202.06,203.13,200.61,200.86,3615266,1.6100000000000136,0.0,1.6100000000000136,85.91571152916168,183.43,203.13,94.56852791878175,-5.431472081218243,3.8622596219214813,2.3966331830594716,0.06526781948544924,-36056005,1.0
1841,HD,1554699600000,203.55,203.79,201.24,201.37,3040935,1.490000000000009,0.0,1.490000000000009,87.46533777774171,183.43,203.79,98.82121807465629,-1.1787819253437173,4.321628320511024,2.7816322105497826,0.07505017428963767,-33015070,1.0
1842,HD,1554786000000,200.9,202.71,200.46,202.26,3721698,-2.6500000000000057,2.6500000000000057,0.0,71.35441503872653,185.5,203.79,84.1990158556589,-15.8009841443411,4.42088723455845,3.109483215351516,0.06155878467635412,-36736768,-1.0
1843,HD,1554872400000,199.43,201.6,198.02,201.26,3587644,-1.4699999999999989,1.4699999999999989,0.0,63.82913348299193,188.39,203.79,71.68831168831179,-28.311688311688204,4.331008751439043,3.353788322569022,0.049300220982847476,-40324412,-1.0
1844,HD,1554958800000,201.48,201.5,199.03,199.9,2465415,2.049999999999983,0.0,2.049999999999983,69.07684687235897,188.39,203.79,84.99999999999999,-15.00000000000001,4.37476767490341,3.5579841930358995,0.049976549064568276,-37858997,1.0
1845,HD,1555045200000,203.85,204.26,202.13,202.13,3097939,2.3700000000000045,0.0,2.3700000000000045,74.09106427495269,188.39,204.26,97.41650913673601,-2.583490863263998,4.548256658529198,3.756038686134559,0.04196483336740964,-34761058,1.0
1846,HD,1555304400000,204.86,205.14,203.40400000000002,204.16,3049880,1.0100000000000193,0.0,1.0100000000000193,76.00432148296676,188.39,205.14,98.3283582089554,-1.6716417910446133,4.7129188917564875,3.947414727258945,0.05429468375276625,-31711178,1.0
1847,HD,1555390800000,204.47,205.99,204.29,205.25,3271592,-0.3900000000000148,0.3900000000000148,0.0,73.5833240589651,189.16,205.99,90.96850861556739,-9.031491384432615,4.757108175433217,4.109353416893799,0.029505060168168784,-34982770,-1.0
1848,HD,1555477200000,206.55,206.84,205.32,205.34,3271891,2.0800000000000125,0.0,2.0800000000000125,77.9128667557703,190.14,206.84,98.26347305389227,-1.7365269461077348,4.903443276028781,4.268171388720796,0.03043152905961599,-31710879,1.0
1849,HD,1555563600000,205.66,207.775,205.1,206.02,3162460,-0.8900000000000148,0.8900000000000148,0.0,72.08035834497305,192.85,207.775,85.82914572864317,-14.170854271356834,4.89121643716777,4.392780398410191,0.017816490151440156,-34873339,-1.0
1850,HD,1555909200000,204.78,206.25,204.0,204.11,2594207,-0.8799999999999955,0.8799999999999955,0.0,66.40867979912733,194.015,207.775,78.23401162790698,-21.765988372093027,4.755697216554125,4.465363762038979,0.006042741341193869,-37467546,-1.0
1851,HD,1555995600000,206.05,207.33,203.43,205.14,3702592,1.2700000000000102,0.0,1.2700000000000102,70.30018306479207,194.11,207.775,87.37650933040618,-12.623490669593817,4.696635750642145,4.511618159759612,0.025634644101543147,-33764954,1.0
1852,HD,1556082000000,206.72,208.295,205.54,206.16,2750949,0.6699999999999875,0.0,0.6699999999999875,72.25663191832669,198.02,208.295,84.67153284671541,-15.328467153284594,4.650286901273375,4.539351908062365,0.03655417941132222,-31014005,1.0
1853,HD,1556168400000,206.5,207.72,205.06,206.01,3292133,-0.21999999999999886,0.21999999999999886,0.0,70.49716081741948,198.02,208.295,82.53041362530422,-17.46958637469578,4.543429120129474,4.5401673504757865,0.02491562437959116,-34306138,-1.0
1854,HD,1556254800000,203.61,206.14,203.34,205.88,3560313,-2.8899999999999864,2.8899999999999864,0.0,51.49213730345847,198.02,208.295,54.40389294403908,-45.596107055960914,4.177390355756728,4.467611951531975,-0.0011773362766739348,-37866451,-1.0
1855,HD,1556514000000,202.16,203.8,200.34,203.31,3785216,-1.450000000000017,1.450000000000017,0.0,44.54073767616259,198.02,208.295,40.291970802919664,-59.708029197080336,3.7273327442883044,4.319556110083241,-0.013179732500244179,-41651667,-1.0
1856,HD,1556600400000,203.7,203.75,200.79,201.55,3415616,1.539999999999992,0.0,1.539999999999992,52.41332246511078,198.02,208.295,55.279805352797965,-44.720194647202035,3.455095780951922,4.146664044256977,-0.003765833618623815,-38236051,1.0
1857,HD,1556686800000,198.8,203.52,198.66,203.2,4644666,-4.899999999999977,4.899999999999977,0.0,34.45627721839597,198.66,208.295,1.453035806953969,-98.54696419304602,2.811547211034565,3.8796406776124948,-0.03752118131203097,-42880717,-1.0
1858,HD,1556773200000,201.01,201.06,198.8,199.3,2810109,2.2099999999999795,0.0,2.2099999999999795,44.37406112057152,198.66,208.295,24.39024390243899,-75.609756097561,2.451598363252373,3.5940322147404706,-0.02261013322960226,-40070608,1.0
1859,HD,1556859600000,200.56,202.31,200.32,202.0,3583835,-0.44999999999998863,0.44999999999998863,0.0,42.85067718103445,198.66,208.295,19.71977166580184,-80.28022833419816,2.105751278941625,3.2963760275807017,-0.020607481199335864,-43654443,-1.0
1860,HD,1557118800000,199.63,199.93,198.31,198.74,2619675,-0.9300000000000068,0.9300000000000068,0.0,39.60815365971689,198.31,208.295,13.219829744616876,-86.78017025538313,1.7366032638385036,2.9844214748322626,-0.031157486047076022,-46274118,-1.0
1861,HD,1557205200000,194.77,197.65,192.96,196.75,4622108,-4.859999999999985,4.859999999999985,0.0,27.19826521865474,192.96,208.295,11.803064884251741,-88.19693511574826,1.0399020752104207,2.5955175949078946,-0.05780766253869962,-50896226,-1.0
1862,HD,1557291600000,195.17,196.61,193.68,194.49,3122569,0.39999999999997726,0.0,0.39999999999997726,29.30186381664913,192.96,208.295,14.411477013367998,-85.588522986632,0.5141116616104853,2.179236408248413,-0.05486682808716714,-47773657,1.0
1863,HD,1557378000000,194.58,195.077,191.59,193.31,2917943,-0.589999999999975,0.589999999999975,0.0,27.92843042898845,191.59,208.295,17.898832684824974,-82.10116731517503,0.049243255951267884,1.7532377777889838,-0.044349491675261477,-50691600,-1.0
1864,HD,1557464400000,194.58,195.49,190.01,193.21,3863576,0.0,0.0,0.0,27.92843042898845,190.01,208.295,24.99316379546088,-75.00683620453911,-0.3155310590917395,1.3394840104128392,-0.037495053423031166,-50691600,0.0
1865,HD,1557723600000,190.34,191.66,189.14,191.0,3326028,-4.240000000000009,4.240000000000009,0.0,19.2814881024468,189.14,208.295,6.264682850430786,-93.73531714956923,-0.9359607240498633,0.8843950635202986,-0.06558664702994588,-54017628,-1.0
1866,HD,1557810000000,191.62,192.76,190.01,190.5,3663632,1.2800000000000011,0.0,1.2800000000000011,27.13929614567516,189.14,207.72,13.347685683530766,-86.65231431646923,-1.309277860708903,0.4456604786744582,-0.036116700201207275,-50353996,1.0
1867,HD,1557896400000,191.76,192.81,190.27,190.81,3355797,0.13999999999998636,0.0,0.13999999999998636,28.023565492652324,189.14,206.14,15.41176470588238,-84.58823529411762,-1.575674160248525,0.04139355088986144,-0.04601761106412616,-46998199,1.0
1868,HD,1557982800000,192.38,194.96,192.2,192.47,3853985,0.6200000000000045,0.0,0.6200000000000045,32.22659167712902,189.14,203.8,22.100954979536176,-77.89904502046382,-1.7169741196001382,-0.31027998320813865,-0.040785799760670205,-43144214,1.0
1869,HD,1558069200000,192.58,194.495,190.75,190.86,5223777,0.20000000000001705,0.0,0.20000000000001705,33.6683055285083,189.14,203.75,23.545516769336228,-76.45448323066377,-1.7921581433701874,-0.6066556152405486,-0.03531533336672832,-37920437,1.0
1870,HD,1558328400000,190.95,192.86,190.61,191.13,4782752,-1.6300000000000239,1.6300000000000239,0.0,28.055895468565595,189.14,203.52,12.586926286509033,-87.41307371349096,-1.9606680407013357,-0.877458100332706,-0.019612876726395334,-42703189,-1.0
1871,HD,1558414800000,191.45,192.52,186.34,187.13,8555840,0.5,0.0,0.5,32.064168849574784,186.34,202.31,31.997495303694336,-68.00250469630566,-2.030461629314658,-1.1080588061290964,-0.019060306399549143,-34147349,1.0
1872,HD,1558501200000,188.91,192.22,188.05,190.49,5706339,-2.539999999999992,2.539999999999992,0.0,24.17076753466371,186.34,202.31,16.092673763306156,-83.90732623669385,-2.2646251345891244,-1.3393720718211022,-0.02913968547641077,-39853688,-1.0
1873,HD,1558587600000,192.0,192.54,186.27,188.45,7754163,3.0900000000000034,0.0,3.0900000000000034,43.64463244640048,186.27,199.93,41.94729136163976,-58.05270863836024,-2.1757831500084706,-1.506654287458576,-0.013259327782917163,-32099525,1.0
1874,HD,1558674000000,193.59,193.86,190.41,192.54,3799486,1.5900000000000034,0.0,1.5900000000000034,51.100623319896364,186.27,197.65,64.323374340949,-35.676625659051005,-1.9545447501233753,-1.596232379991536,0.017074708416517703,-28300039,1.0
1875,HD,1559019600000,191.55,196.47,191.35,194.38,5165764,-2.039999999999992,2.039999999999992,0.0,42.73119056776211,186.27,196.61,51.06382978723404,-48.93617021276596,-1.9216708499270112,-1.6613200739786314,-0.0003653063354555064,-33465803,-1.0
1876,HD,1559106000000,189.99,191.88,188.03,190.28,4569945,-1.5600000000000023,1.5600000000000023,0.0,37.33564002842828,186.27,196.47,36.47058823529415,-63.529411764705856,-1.998460006753902,-1.728748060533686,-0.009230287859824715,-38035748,-1.0
1877,HD,1559192400000,191.08,192.5,190.09,190.13,3029849,1.0900000000000034,0.0,1.0900000000000034,43.12538032459361,186.27,196.47,47.15686274509812,-52.84313725490188,-1.948896411598355,-1.7727777307466197,-0.00675745919534243,-35005899,1.0
1878,HD,1559278800000,189.85,190.29,188.66,189.64,3681598,-1.2300000000000182,1.2300000000000182,0.0,38.49449885083632,186.27,196.47,35.09803921568616,-64.90196078431384,-1.9859745474553847,-1.815417094088373,-0.014175926887527335,-38687497,-1.0
1879,HD,1559538000000,189.57,191.87,188.75,189.52,4620379,-0.28000000000000114,0.28000000000000114,0.0,37.43853181001587,186.27,196.47,32.35294117647046,-67.64705882352953,-2.014728362757012,-1.8552793478221008,-0.007227022780832648,-43307876,-1.0
1880,HD,1559624400000,195.25,195.5,191.42,191.58,5118128,5.680000000000007,0.0,5.680000000000007,61.90111000534563,186.27,196.47,88.0392156862745,-11.960784313725492,-1.5611910002412515,-1.7964616783059313,0.019848524418908386,-38189748,1.0
1881,HD,1559710800000,196.69,196.72,193.08,194.01,3704587,1.4399999999999977,0.0,1.4399999999999977,65.81164003938045,186.27,196.72,99.71291866028707,-0.2870813397129299,-1.0731923145068265,-1.6518078055461103,0.041183632417553406,-34485161,1.0
1882,HD,1559797200000,197.17,197.65,194.96,196.65,3732940,0.47999999999998977,0.0,0.47999999999998977,67.11005382472693,186.27,197.65,95.7820738137081,-4.217926186291901,-0.6403364517290697,-1.4495135347827024,0.026927083333333268,-30752221,1.0
1883,HD,1559883600000,197.3,199.02,196.21,197.2,3522396,0.13000000000002387,0.0,0.13000000000002387,67.49581994795554,186.27,199.02,86.50980392156865,-13.490196078431364,-0.28353671363566946,-1.216318170553296,0.019164213027532462,-27229825,1.0
1884,HD,1560142800000,198.05,199.85,197.32,198.56,3154460,0.75,0.0,0.75,69.84987119720223,186.27,199.85,86.74521354933738,-13.254786450662628,0.05906748815985452,-0.9612410388106658,0.03393369877316621,-24075365,1.0
1885,HD,1560229200000,198.01,200.84,195.84,199.02,3708474,-0.040000000000020464,0.040000000000020464,0.0,69.53994543445089,186.27,200.84,80.57652711050093,-19.423472889499067,0.3236255666245995,-0.7042677177236127,0.04221274803937036,-27783839,-1.0
1886,HD,1560315600000,198.94,200.185,197.98,198.81,2551590,0.9300000000000068,0.0,0.9300000000000068,72.77999153131302,186.27,200.84,86.95950583390524,-13.04049416609476,0.6014004079673327,-0.44313409258542363,0.04113460330751506,-25232249,1.0
1887,HD,1560402000000,202.35,202.68,199.45,199.95,3631270,3.4099999999999966,0.0,3.4099999999999966,81.2279470676346,188.03,202.68,97.74744027303745,-2.252559726962542,1.0841994955381438,-0.13766737496071008,0.06584145377929951,-21600979,1.0
1888,HD,1560488400000,205.77,206.5,201.31,201.31,4898440,3.420000000000016,0.0,3.420000000000016,86.18844753349524,188.03,206.5,96.04764482945323,-3.952355170546778,1.7229258519478208,0.23445127042099623,0.08545655958221254,-16702539,1.0
1889,HD,1560747600000,206.98,208.79,206.0,207.0,4620500,1.2099999999999795,0.0,1.2099999999999795,87.533293740353,188.03,208.79,91.28131021194604,-8.718689788053965,2.300242218343442,0.6476094600054855,0.06007682458386676,-12082039,1.0
1890,HD,1560834000000,207.48,210.17,207.11,208.1,3891295,0.5,0.0,0.5,88.08639647858462,188.66,210.17,87.49418874941888,-12.50581125058112,2.766228064170889,1.0713331808385664,0.05485789821546594,-8190744,1.0
1891,HD,1560920400000,207.94,208.48,205.9,207.9,3648435,0.46000000000000796,0.0,0.46000000000000796,88.62225013398319,188.66,210.17,89.63272896327294,-10.367271036727061,3.1364878799710425,1.4843641206650617,0.05462291423644583,-4542309,1.0
1892,HD,1561006800000,211.25,211.66,209.31,209.57,5171454,3.3100000000000023,0.0,3.3100000000000023,91.715875607419,188.75,211.66,98.21038847664776,-1.7896115233522334,3.6548796116666153,1.9184672188653729,0.07070451089711094,629145,1.0
1893,HD,1561093200000,209.39,211.99,209.08,211.26,9854979,-1.8600000000000136,1.8600000000000136,0.0,77.97001788573513,191.42,211.99,87.36023334953806,-12.639766650461933,3.8709998617225096,2.3089737474368004,0.0572582681141125,-9225834,-1.0
1894,HD,1561352400000,205.5,209.26,205.12,208.15,4943452,-3.8899999999999864,3.8899999999999864,0.0,57.26060369720783,193.08,211.99,65.67953463775774,-34.32046536224225,3.68589749510852,2.5843584969711446,0.03782637240543418,-14169286,-1.0
1895,HD,1561438800000,204.74,207.1,204.2,206.3,3588178,-0.7599999999999909,0.7599999999999909,0.0,54.025762376270045,194.96,211.99,57.428068115091015,-42.571931884908985,3.4382429629168314,2.7551353901602824,0.029154518950437414,-17757464,-1.0
1896,HD,1561525200000,206.42,207.32,204.65,205.34,3071224,1.6799999999999784,0.0,1.6799999999999784,59.815970096872135,195.84,211.99,65.51083591331258,-34.48916408668743,3.33904647230608,2.871917606589442,0.020113664442797052,-14686240,1.0
1897,HD,1561611600000,207.02,208.0,206.01,207.61,2286764,0.6000000000000227,0.0,0.6000000000000227,61.79863085847376,195.84,211.99,69.22600619195049,-30.773993808049514,3.271139860319778,2.9517620573355097,0.00607474364581817,-12399476,1.0
1898,HD,1561698000000,207.97,209.0,207.39,207.77,11068972,0.9499999999999886,0.0,0.9499999999999886,64.95735743100617,195.84,211.99,75.10835913312688,-24.891640866873118,3.256442202947966,3.012698086458001,0.004783070828099367,-1330504,1.0
1899,HD,1561957200000,210.28,212.31,208.17,209.7,4100105,2.3100000000000023,0.0,2.3100000000000023,71.55606724445605,197.98,212.31,85.83391486392185,-14.166085136078152,3.3920899961415216,3.0885764683947055,0.013495276653171517,2769601,1.0
1900,HD,1562043600000,210.14,210.26,208.46,210.24,3160610,-0.14000000000001478,0.14000000000001478,0.0,70.62604987329446,199.45,212.31,83.12597200622074,-16.87402799377927,3.448542369770223,3.1605696486698096,0.0105799749927864,-391009,-1.0
1901,HD,1562130000000,212.1,212.75,209.7,209.82,2183742,1.960000000000008,0.0,1.960000000000008,75.72305018338155,201.31,212.75,94.31818181818177,-5.681818181818233,3.6098250856357765,3.250420736063003,0.004023668639053124,1792733,1.0
1902,HD,1562302800000,211.46,212.17,209.7261,209.97,2547864,-0.6399999999999864,0.6399999999999864,0.0,71.07630398456661,204.2,212.75,84.9122807017545,-15.0877192982455,3.64399444894201,3.3291354786388054,0.009885858923539992,-755131,-1.0
1903,HD,1562562000000,212.91,213.44,210.59,210.98,2705327,1.4499999999999886,0.0,1.4499999999999886,75.07479025844287,204.2,213.44,94.26406926406926,-5.735930735930743,3.744907831031611,3.412289949117367,0.03605839416058387,1950196,1.0
1904,HD,1562648400000,212.0,213.33,211.2,211.93,2397527,-0.9099999999999966,0.9099999999999966,0.0,68.24319012737874,204.2,213.44,84.41558441558445,-15.584415584415545,3.7087014172153943,3.4715722427369724,0.03545960730682807,-447331,-1.0
1905,HD,1562734800000,210.75,211.32,208.8268,210.72,3457376,-1.25,1.25,0.0,59.6413337841162,204.2,213.44,70.88744588744595,-29.112554112554058,3.5383550654537714,3.4849288072803324,0.020976649549462323,-3904707,-1.0
1906,HD,1562821200000,214.04,214.08,211.02,212.25,3450056,3.289999999999992,0.0,3.289999999999992,70.81370996981732,204.2,214.08,99.59514170040465,-0.40485829959534786,3.627019831846212,3.513347012193509,0.03390976717225369,-454651,1.0
1907,HD,1562907600000,218.23,218.25,214.61,215.0,4429826,4.189999999999998,0.0,4.189999999999998,79.25333389430342,204.2,218.25,99.85765124555152,-0.14234875444847128,3.9893979840699103,3.60855720656879,0.04933403856325436,3975175,1.0
1908,HD,1563166800000,218.7,219.2951,216.81,218.95,3141289,0.46999999999999886,0.0,0.46999999999999886,80.00179121510905,204.2,219.2951,96.05766109532232,-3.9423389046776904,4.265342143401114,3.7399141939352547,0.040041848963287,7116464,1.0
1909,HD,1563253200000,217.26,218.35,216.73,217.3,2657421,-1.4399999999999977,1.4399999999999977,0.0,70.95278824552115,204.65,219.2951,86.10388457572839,-13.896115424271613,4.318058027282802,3.8555429606047644,0.03388217378890257,4459043,-1.0
1910,HD,1563339600000,215.61,217.58,215.61,216.73,3037577,-1.6499999999999773,1.6499999999999773,0.0,61.722525446744854,206.01,219.2951,72.26140563488437,-27.738594365115638,4.178527075597174,3.920139783603247,0.016548797736916532,1421466,-1.0
1911,HD,1563426000000,214.44,216.23,213.01,215.5,3069619,-1.170000000000016,1.170000000000016,0.0,55.78492119871411,207.39,219.2951,59.218318199763196,-40.781681800236804,3.9282560784007785,3.921763042562753,0.014092499763548538,-1648153,-1.0
1912,HD,1563512400000,213.04,215.23,212.93,214.67,3255033,-1.4000000000000057,1.4000000000000057,0.0,49.2443716336203,208.17,219.2951,43.774887416742345,-56.225112583257655,3.5757274500742255,3.8525559240650478,0.0006105866328496301,-4903186,-1.0
1913,HD,1563771600000,211.27,213.26,210.38,213.0,2765719,-1.7699999999999818,1.7699999999999818,0.0,42.05192800362773,208.46,219.2951,25.934232263661684,-74.06576773633832,3.117584194831778,3.705561578218394,-0.0034433962264150964,-7668905,-1.0
1914,HD,1563858000000,213.08,214.13,211.726,212.57,2590137,1.8100000000000023,0.0,1.8100000000000023,50.570374534060065,208.8268,219.2951,40.62932854427196,-59.37067145572804,2.867499488361659,3.537949160247047,0.011055753262158907,-5078768,1.0
1915,HD,1563944400000,214.71,214.79,213.07,213.19,2207164,1.6299999999999955,0.0,1.6299999999999955,57.12021793149132,208.8268,219.2951,56.200147110801346,-43.79985288919866,2.7689146102057975,3.384142250238797,0.0031302560269108604,-2871604,1.0
1916,HD,1564030800000,215.55,215.92,213.63,214.28,2335396,0.8400000000000034,0.0,0.8400000000000034,60.25204634426814,208.8268,219.2951,64.22437262974906,-35.775627370250945,2.7271297101097787,3.2527397422129933,-0.012280621362782296,-536208,1.0
1917,HD,1564117200000,216.91,217.21,214.1,215.53,2675559,1.3599999999999852,0.0,1.3599999999999852,65.0242595374751,208.8268,219.2951,77.2159758509023,-22.784024149097696,2.771803880004825,3.15655256977136,-0.008184727937814329,2139351,1.0
1918,HD,1564376400000,218.04,218.27,216.35,216.79,2407248,1.1299999999999955,0.0,1.1299999999999955,68.63456403612571,208.8268,219.2951,88.01046970377236,-11.989530296227647,2.8653599518028727,3.098314046177663,0.0035901684617509755,4546599,1.0
1919,HD,1564462800000,217.36,218.59,216.86,217.52,2172571,-0.6799999999999784,0.6799999999999784,0.0,64.04431867155814,210.38,219.2951,78.29413018362129,-21.70586981637871,2.851760179544357,3.049003272851002,0.008116506655535538,2374028,-1.0
1920,HD,1564549200000,213.69,217.8,212.165,216.35,3426412,-3.670000000000016,3.670000000000016,0.0,45.21359166440725,210.38,219.2951,37.12801875469714,-62.87198124530286,2.5158428630507217,2.9423711908909462,-0.003497481813094616,-1052384,-1.0
1921,HD,1564635600000,212.83,217.61,212.02,214.14,3431473,-0.8599999999999852,0.8599999999999852,0.0,41.88382992534264,210.38,219.2951,27.481464032933093,-72.51853596706691,2.1553852177858914,2.7849739962699354,-0.00098573037927141,-4483857,-1.0
1922,HD,1564722000000,212.15,213.14,211.0812,211.86,2884886,-0.6800000000000068,0.6800000000000068,0.0,39.246847149589144,210.38,218.59,21.559074299634695,-78.4409257003653,1.794167573002511,2.5868127116164508,0.004165286126757151,-7368743,-1.0
1923,HD,1564981200000,204.94,209.99,204.08,209.53,4553198,-7.210000000000008,7.210000000000008,0.0,22.170151787519742,204.08,218.59,5.926946933149454,-94.07305306685055,0.9155592464855715,2.252562018590275,-0.038201614417120444,-11921941,-1.0
1924,HD,1565067600000,208.8,209.09,204.5,205.01,3646800,3.8600000000000136,0.0,3.8600000000000136,38.65778919097259,204.08,218.59,32.52929014472778,-67.47070985527222,0.5246774038128876,1.9069850956347973,-0.027525499510968277,-8275141,1.0
1925,HD,1565154000000,207.91,208.5,203.13,206.04,3901105,-0.8900000000000148,0.8900000000000148,0.0,36.595315808199324,203.13,218.59,30.91849935316946,-69.08150064683053,0.14145456520827793,1.5538789895494936,-0.0354442124797032,-12176246,-1.0
1926,HD,1565240400000,211.57,211.69,208.7201,209.7,2968173,3.6599999999999966,0.0,3.6599999999999966,49.40404684724655,203.13,218.59,54.59249676584731,-45.4075032341527,0.13156254561533842,1.2694157007626625,-0.024618505370891164,-9208073,1.0
1927,HD,1565326800000,210.02,212.4123,207.95,211.45,2912078,-1.549999999999983,1.549999999999983,0.0,44.96529627389308,203.13,218.59,44.566623544631376,-55.433376455368624,-0.0013336241012211758,1.0152658357898858,-0.03678224179049705,-12120151,-1.0
1928,HD,1565586000000,207.01,209.64,206.15,208.1,1998385,-3.0100000000000193,3.0100000000000193,0.0,37.42999400340251,203.13,218.59,25.097024579560113,-74.90297542043989,-0.34555331690933144,0.7431020052500423,-0.04761685682738326,-14118536,-1.0
1929,HD,1565672400000,208.33,211.62,204.78,206.31,3906289,1.3200000000000216,0.0,1.3200000000000216,42.320980153422944,203.13,218.59,33.63518758085391,-66.36481241914609,-0.5060040355834019,0.4932807970833535,-0.025083064251953724,-10212247,1.0
1930,HD,1565758800000,201.59,205.36,201.51,204.46,4582123,-6.740000000000009,6.740000000000009,0.0,28.976323797953825,201.51,218.59,0.46838407494152484,-99.53161592505847,-1.163610678013697,0.1619025020639433,-0.052812103556829415,-14794370,-1.0
1931,HD,1565845200000,201.79,203.76,199.05,203.0,4199748,0.19999999999998863,0.0,0.19999999999998863,29.734917518542673,199.05,218.59,14.02251791197534,-85.97748208802466,-1.6496146209090625,-0.20040092253065797,-0.048833372613716786,-10594622,1.0
1932,HD,1565931600000,203.65,204.43,201.6701,203.75,4093594,1.8600000000000136,0.0,1.8600000000000136,36.960154424667294,199.05,218.59,23.54145342886385,-76.45854657113615,-1.863211845446358,-0.5329631071137981,-0.006294525226895664,-6501028,1.0
1933,HD,1566190800000,207.95,208.82,205.3,206.98,6413591,4.299999999999983,0.0,4.299999999999983,50.52958204630719,199.05,217.8,47.46666666666655,-52.53333333333345,-1.666306971845131,-0.7596318800600648,-0.004070881226053702,-87437,1.0
1934,HD,1566277200000,217.09,217.85,212.17,213.5,12455056,9.140000000000015,0.0,9.140000000000015,67.62247782632447,199.05,217.85,95.95744680851068,-4.042553191489317,-0.7639307093730281,-0.7604916459226575,0.044153720359771054,12367619,1.0
1935,HD,1566363600000,220.4,220.88,216.76,218.73,7940577,3.3100000000000023,0.0,3.3100000000000023,71.70730829713644,199.05,220.88,97.80119102153006,-2.19880897846995,0.2158105869726228,-0.5652311993436014,0.0417355957839014,20308196,1.0
1936,HD,1566450000000,221.02,222.655,219.88,220.05,4545216,0.6200000000000045,0.0,0.6200000000000045,72.45829601835595,199.05,222.655,93.07350137682698,-6.92649862317302,1.0304134762807848,-0.2461022642187241,0.05237596419388635,24853412,1.0
1937,HD,1566536400000,217.47,220.87,216.01,219.9,5770379,-3.5500000000000114,3.5500000000000114,0.0,61.647480184606515,199.05,222.655,78.0343147638212,-21.965685236178796,1.3737016262939505,0.07785851388381092,0.050528959953625385,19083033,-1.0
1938,HD,1566795600000,218.65,219.5,216.18,218.46,3680273,1.1800000000000068,0.0,1.1800000000000068,63.72334536280759,199.05,222.655,83.03325566617244,-16.966744333827567,1.721135913326549,0.4065139937723587,0.04953679258868138,22763306,1.0
1939,HD,1566882000000,218.21,220.41,217.91,219.55,4313269,-0.4399999999999977,0.4399999999999977,0.0,62.27315607229127,199.05,222.655,81.16924380427878,-18.830756195721225,1.9386284639837186,0.7129368878146308,0.08244456570266379,18450037,-1.0
1940,HD,1566968400000,221.95,222.09,217.11,217.88,3072754,3.7399999999999807,0.0,3.7399999999999807,69.15724047531248,199.05,222.655,97.01334463037486,-2.986655369625134,2.385283556789375,1.0474062216095799,0.09990584270776548,21522791,1.0
1941,HD,1567054800000,227.32,227.7,223.76,223.9,4184912,5.3700000000000045,0.0,5.3700000000000045,76.31680480493367,199.05,227.7,98.673647469459,-1.3263525305409973,3.1364203553489176,1.4652090483574476,0.11622882396268097,25707703,1.0
1942,HD,1567141200000,227.91,229.27,226.69,228.43,3769326,0.5900000000000034,0.0,0.5900000000000034,76.99382771967821,199.05,229.27,95.49966909331565,-4.50033090668436,3.736240692051126,1.9194153770961837,0.09598461168550143,29477029,1.0
1943,HD,1567486800000,224.07,227.63,223.38,226.45,4139414,-3.8400000000000034,3.8400000000000034,0.0,63.38613575373513,199.05,229.27,82.79285241561874,-17.20714758438126,3.857282372463942,2.3069887761697356,0.032152563452945815,25337615,-1.0
1944,HD,1567573200000,224.15,224.15,220.67,223.95,3146989,0.0800000000000125,0.0,0.0800000000000125,63.54103154054128,199.05,229.27,83.0575777630708,-16.942422236929204,3.91453973036613,2.6284989670090146,0.01701451905626139,28484604,1.0
1945,HD,1567659600000,228.15,228.78,226.25,226.3,3373539,4.0,0.0,4.0,70.69376414231691,201.6701,229.27,95.94201428266042,-4.0579857173395695,4.233877663419236,2.949574706291059,0.032259524024975006,31858143,1.0
1946,HD,1567746000000,231.13,231.37,227.88,228.7,3237893,2.9799999999999898,0.0,2.9799999999999898,74.92287889574392,205.3,231.37,99.07940161104715,-0.9205983889528544,4.673542680330684,3.294368301098984,0.06281326159930112,35096036,1.0
1947,HD,1568005200000,232.87,233.87,230.075,231.5,4449066,1.740000000000009,0.0,1.740000000000009,77.14492455733102,212.17,233.87,95.39170506912443,-4.608294930875573,5.103553247080924,3.656205290295372,0.06503544477475409,39545102,1.0
1948,HD,1568091600000,233.0,233.02,229.7117,232.25,4210672,0.12999999999999545,0.0,0.12999999999999545,77.31818329630416,216.01,233.87,95.12877939529673,-4.871220604703269,5.392666332174912,4.003497498671281,0.06777874524540572,43755774,1.0
1949,HD,1568178000000,232.66,233.68,231.02,232.93,2978346,-0.3400000000000034,0.3400000000000034,0.0,75.58894733425306,216.01,233.87,93.22508398656211,-6.77491601343789,5.5306020389332105,4.3089184067236665,0.04825411128632573,40777428,-1.0
1950,HD,1568264400000,233.8,235.49,233.11,233.42,3366138,1.1400000000000148,0.0,1.1400000000000148,77.53293209726706,216.01,235.49,91.32443531827518,-8.675564681724826,5.666584691932599,4.580451663765453,0.028506070737286615,44143566,1.0
1951,HD,1568350800000,233.98,234.97,232.33,234.33,3805519,0.1799999999999784,0.0,0.1799999999999784,77.85423350315918,216.18,235.49,92.1802175038839,-7.819782496116101,5.7229063181636946,4.808942594645102,0.02663332017024267,47949085,1.0
1952,HD,1568610000000,230.99,233.61,230.61,232.73,3120219,-2.9899999999999807,2.9899999999999807,0.0,61.1051625703595,217.11,235.49,75.51686615886834,-24.48313384113167,5.463296124263053,4.939813300568693,0.03088320614093809,44828866,-1.0
1953,HD,1568696400000,230.21,230.33,226.47,226.79,3806137,-0.7800000000000011,0.7800000000000011,0.0,57.388889400503245,217.11,235.49,71.27312295973883,-28.72687704026117,5.135415817084379,4.97893380387183,0.02703546732099049,41022729,-1.0
1954,HD,1568782800000,230.83,231.53,229.01,230.37,3423131,0.6200000000000045,0.0,0.6200000000000045,59.64014259832648,220.67,235.49,68.55600539811073,-31.44399460188927,4.869464968815208,4.957040036860506,0.01174665790050411,44445860,1.0
1955,HD,1568869200000,228.12,231.4,227.95,231.15,3254884,-2.710000000000008,2.710000000000008,0.0,47.092121207560425,220.67,235.49,50.26990553306347,-49.73009446693653,4.389424105142041,4.843516850516814,-0.013022974083848893,41190976,-1.0
1956,HD,1568955600000,224.67,230.05,224.23,227.99,7797035,-3.450000000000017,3.450000000000017,0.0,35.97416399567763,220.67,235.49,26.99055330634274,-73.00944669365725,3.68808811103753,4.612431102620957,-0.035212779662472715,33393941,-1.0
1957,HD,1569214800000,226.25,227.14,223.95,224.16,2955323,1.5800000000000125,0.0,1.5800000000000125,43.07581702352751,220.67,235.49,37.65182186234821,-62.348178137651786,3.2226187354737306,4.3344686291915115,-0.02896995708154504,36349264,1.0
1958,HD,1569301200000,225.41,230.2383,224.78,228.14,4518353,-0.8400000000000034,0.8400000000000034,0.0,40.33159233904457,223.95,235.49,12.651646447140427,-87.34835355285956,2.754201204926943,4.018415144338598,-0.03116135132811826,31830911,-1.0
1959,HD,1569387600000,228.1,228.45,224.5,226.59,3969380,2.6899999999999977,0.0,2.6899999999999977,51.70115562502915,223.95,235.49,35.96187175043326,-64.03812824956674,2.570407399456599,3.728813595362198,-0.024379811804961626,35800291,1.0
1960,HD,1569474000000,229.79,231.12,229.0,229.68,4383280,1.6899999999999977,0.0,1.6899999999999977,57.56290580282121,223.95,235.49,50.60658578856147,-49.39341421143853,2.531931826515944,3.489437241592947,-0.01790751346268915,40183571,1.0
1961,HD,1569560400000,229.86,231.75,229.13,231.61,3152242,0.0700000000000216,0.0,0.0700000000000216,57.80763381879825,223.95,235.49,51.21317157712318,-48.78682842287682,2.478517268496745,3.2872532469737066,-0.004891986666089476,43335813,1.0
1962,HD,1569819600000,232.02,232.59,230.12,230.19,3258468,2.1599999999999966,0.0,2.1599999999999966,64.99502716837266,223.95,235.49,69.93067590987874,-30.069324090121253,2.5807307370743047,3.145948744993827,0.007862386516658715,46594281,1.0
1963,HD,1569906000000,231.08,234.51,230.72,233.01,3530209,-0.9399999999999977,0.9399999999999977,0.0,59.873557506895786,223.95,235.49,61.785095320624016,-38.21490467937599,2.5564167225743972,3.0280423405099413,0.001083048130658959,43064072,-1.0
1964,HD,1569992400000,225.55,230.6,224.34,230.6,4371896,-5.530000000000001,5.530000000000001,0.0,39.00852116480707,223.95,234.97,14.519056261343206,-85.48094373865679,2.067094725771625,2.8358528175622784,-0.011266000350692584,38692176,-1.0
1965,HD,1570078800000,226.81,226.81,222.12,225.0,2972928,1.259999999999991,0.0,1.259999999999991,44.12741548681186,222.12,234.51,37.85310734463279,-62.1468926553672,1.7606789764159316,2.620818049333009,0.009525081230248977,41665104,1.0
1966,HD,1570165200000,227.93,229.21,227.02,227.17,3188709,1.1200000000000045,0.0,1.1200000000000045,48.55573877856334,222.12,234.51,46.892655367231704,-53.107344632768296,1.5898896687849913,2.4146323732234056,0.007425414364640837,44853813,1.0
1967,HD,1570424400000,226.74,228.13,226.05,227.51,2967658,-1.1899999999999977,1.1899999999999977,0.0,44.2555714380343,222.12,234.51,37.28813559322042,-62.71186440677958,1.3430332064668562,2.2003125398720957,0.0059003593451931735,41886155,-1.0
1968,HD,1570510800000,226.67,228.78,225.1,225.36,3567904,-0.0700000000000216,0.0700000000000216,0.0,43.9911424782892,222.12,234.51,36.72316384180781,-63.27683615819218,1.1287378789359082,1.9859976076848582,-0.006269180184129808,38318251,-1.0
1969,HD,1570597200000,228.94,229.56,226.61,228.5,2675389,2.2700000000000102,0.0,2.2700000000000102,54.22511120500258,222.12,234.51,55.04439063761099,-44.95560936238901,1.1290621906545937,1.8146105242788053,-0.003699029548718369,40993640,1.0
1970,HD,1570683600000,231.61,232.24,229.08,229.34,3052401,2.670000000000016,0.0,2.670000000000016,63.320882980019405,222.12,234.51,76.59402744148522,-23.405972558514772,1.3294409284324331,1.7175766051095307,0.007613329852953932,44046041,1.0
1971,HD,1570770000000,234.66,236.7,233.76,234.32,3479059,3.049999999999983,0.0,3.049999999999983,70.93360418066831,222.12,236.7,86.00823045267494,-13.991769547325065,1.7145873363389512,1.7169787513554147,0.011378329454357239,47525100,1.0
1972,HD,1571029200000,234.18,235.485,234.06,234.22,2538129,-0.47999999999998977,0.47999999999998977,0.0,68.35731074924458,222.12,236.7,82.71604938271615,-17.283950617283843,1.958510164911388,1.7652850340666095,0.013415267439847556,44986971,-1.0
1973,HD,1571115600000,235.62,236.86,234.6,234.69,2667156,1.4399999999999977,0.0,1.4399999999999977,71.89121323506623,222.12,236.86,91.58751696065123,-8.412483039348768,2.2421703848480377,1.860662104222895,0.04464641986255824,47654127,1.0
1974,HD,1571202000000,235.9,236.17,233.84,235.42,2389282,0.28000000000000114,0.0,0.28000000000000114,72.57831144206423,222.12,236.86,93.4871099050203,-6.512890094979697,2.4611956809824846,1.9807688195748132,0.04007759798950672,50043409,1.0
1975,HD,1571288400000,236.77,238.1736,235.51,236.36,2296853,0.8700000000000045,0.0,0.8700000000000045,74.78782258847914,222.12,238.1736,91.25678975432312,-8.743210245676883,2.6741505918458586,2.1194451740290225,0.0387838371429825,52340262,1.0
1976,HD,1571374800000,237.93,238.73,235.64,236.99,3663925,1.1599999999999966,0.0,1.1599999999999966,77.56847922528947,222.12,238.73,95.18362432269727,-4.816375677302731,2.9030565693958863,2.276167453102395,0.049351680338713955,56004187,1.0
1977,HD,1571634000000,236.7,238.99,235.61,238.26,2079644,-1.2300000000000182,1.2300000000000182,0.0,68.3460476110718,222.12,238.99,86.42560758743319,-13.574392412566805,2.9511959356314605,2.4111731496082083,0.044249349274275485,53924543,-1.0
1978,HD,1571720400000,237.2,238.3,236.516,237.3,2022890,0.5,0.0,0.5,70.01803522493123,222.12,238.99,89.38944872554819,-10.610551274451808,2.995166140680567,2.52797174782268,0.03607932209312481,55947433,1.0
1979,HD,1571806800000,234.67,237.41,234.36,236.66,2138451,-2.530000000000001,2.530000000000001,0.0,53.51455744219703,225.1,238.99,68.89848812095019,-31.1015118790498,2.7936594222354927,2.581109282705243,0.013211864772677995,53808982,-1.0
1980,HD,1571893200000,233.89,236.37,233.07,234.81,2184113,-0.7800000000000011,0.7800000000000011,0.0,49.37464173415486,225.1,238.99,63.282937365010675,-36.717062634989325,2.5417249912915167,2.573232424422498,-0.0032813432199778614,51624869,-1.0
1981,HD,1571979600000,234.38,235.42,232.55,233.49,2210872,0.4900000000000091,0.0,0.4900000000000091,52.062722480483906,225.1,238.99,66.81065514758812,-33.189344852411864,2.3544632577451807,2.5294785910870345,0.0008540438978563714,53835741,1.0
1982,HD,1572238800000,236.8,236.96,234.56,234.95,2705001,2.420000000000016,0.0,2.420000000000016,63.19823166365778,226.61,238.99,82.3101777059774,-17.689822294022605,2.3739651672716207,2.498375906323952,0.005008063831593246,56540742,1.0
1983,HD,1572325200000,234.14,237.5,233.92,236.84,2558004,-2.660000000000025,2.660000000000025,0.0,48.8163375889313,229.08,238.99,51.05953582240137,-48.94046417759863,2.1499969748234378,2.4287001200238496,-0.007460788469690671,53982738,-1.0
1984,HD,1572411600000,236.24,236.6,232.88,233.51,1956669,2.1000000000000227,0.0,2.1000000000000227,57.60480859720843,232.55,238.99,57.298136645962714,-42.701863354037286,2.1175432972663373,2.366468755472347,-0.0022384592642649137,55939407,1.0
1985,HD,1572498000000,234.58,237.39,233.22,236.86,2824072,-1.6599999999999966,1.6599999999999966,0.0,49.804880975976246,232.55,238.99,31.52173913043481,-68.47826086956519,1.9355634268467554,2.280287689747229,-0.014079771361324767,53115335,-1.0
1986,HD,1572584400000,237.34,237.445,235.06099999999998,236.07,2197403,2.759999999999991,0.0,2.759999999999991,60.15517447344689,232.55,238.99,74.37888198757754,-25.621118012422457,1.991099842593826,2.2224501203165485,0.0027038445289395696,55312738,1.0
1987,HD,1572847200000,234.92,238.39,233.88,238.27,2542426,-2.420000000000016,2.420000000000016,0.0,49.77199390700423,232.55,238.99,36.80124223602449,-63.19875776397551,1.8188722498875052,2.1417345462307398,-0.009612141652613815,52770312,-1.0
1988,HD,1572933600000,232.2,234.92,230.27,234.74,3624629,-2.719999999999999,2.719999999999999,0.0,40.66834740698104,230.27,238.99,22.133027522935535,-77.86697247706446,1.4462281558880932,2.0026332681622105,-0.010525418673030251,49145683,-1.0
1989,HD,1573020000000,234.01,234.04,231.89,232.83,2631943,1.8100000000000023,0.0,1.8100000000000023,47.974727884382865,230.27,238.99,42.88990825688052,-57.11009174311948,1.2821767642260227,1.858541967374973,0.0005130616956690037,51777626,1.0
1990,HD,1573106400000,232.94,235.79,231.76,234.0,2832865,-1.0699999999999932,1.0699999999999932,0.0,44.25721067582688,230.27,238.99,30.61926605504573,-69.38073394495426,1.0536786452403817,1.6975693029480547,-0.006143868930796104,48944761,-1.0
1991,HD,1573192800000,232.84,233.26,231.6313,232.8,2088455,-0.09999999999999432,0.09999999999999432,0.0,43.89045681229485,230.27,238.39,31.650246305418726,-68.34975369458127,0.8546709606192167,1.528989634482287,-0.016722972972972983,46856306,-1.0
1992,HD,1573452000000,231.8,232.28,230.18,230.5,2310669,-1.039999999999992,1.039999999999992,0.0,39.9206488690005,230.18,238.39,19.732034104750408,-80.26796589524959,0.6060504560229276,1.3444017987904153,-0.0099940206713931,44545637,-1.0
1993,HD,1573538400000,233.12,234.63,232.0,232.15,2991171,1.3199999999999932,0.0,1.3199999999999932,46.94797143473082,230.18,238.39,35.8099878197321,-64.19001218026791,0.5096548987919789,1.177452418790728,-0.01320690822891979,47536808,1.0
1994,HD,1573624800000,234.8,234.9,230.85,232.09,2625015,1.6800000000000068,0.0,1.6800000000000068,54.724888095166044,230.18,238.39,56.27283800243625,-43.727161997563755,0.5623403750492457,1.0544300100424315,0.0009378463637139678,50161823,1.0
1995,HD,1573711200000,236.55,236.94,234.04,235.0,2283848,1.75,0.0,1.75,61.50698582291178,230.18,238.39,77.588306942753,-22.41169305724701,0.7368108721163935,0.990906182457224,-0.0033285581865677427,52445671,1.0
1996,HD,1573797600000,237.29,238.05,236.36,237.69,3526672,0.7399999999999807,0.0,0.7399999999999807,64.1287442310041,230.18,238.39,86.60170523751526,-13.398294762484738,0.9241389154354636,0.9775527290528719,0.010088540779839894,55972343,1.0
1997,HD,1574056800000,238.85,239.3091,236.76,238.44,5766962,1.5600000000000023,0.0,1.5600000000000023,69.22699750952164,230.18,239.3091,94.97102671676281,-5.028973283237195,1.1848188477744657,1.0190059527971909,0.028639104220499645,61739305,1.0
1998,HD,1574143200000,225.86,233.12,225.4,230.6,14984830,-12.98999999999998,12.98999999999998,0.0,29.264664454929957,225.4,239.3091,3.307187380923339,-96.69281261907666,0.3393137366694532,0.8830675095716433,-0.03482757147130455,46754475,-1.0
1999,HD,1574229600000,220.9,225.0,220.57,224.55,10228810,-4.960000000000008,4.960000000000008,0.0,23.330933105508507,220.57,239.3091,1.7610237418019667,-98.23897625819804,-0.7226553815657439,0.5619229313441657,-0.0516871297329784,36525665,-1.0
2000,HD,1574316000000,218.54,222.31,218.5,221.94,7823720,-2.3600000000000136,2.3600000000000136,0.0,20.993944432921452,218.5,239.3091,0.19222359448506682,-99.80777640551494,-1.7347091878005756,0.1025965075152173,-0.0614155643360248,28701945,-1.0
2001,HD,1574402400000,218.03,219.13,217.81,218.5,5786478,-0.5099999999999909,0.5099999999999909,0.0,20.482367753950058,217.81,239.3091,1.0232986497109129,-98.97670135028909,-2.5485438315708677,-0.42763156030199984,-0.05940465918895599,22915467,-1.0
2002,HD,1574661600000,218.4,218.53,216.88,218.0,8869811,0.37000000000000455,0.0,0.37000000000000455,22.071974947916047,216.88,239.3091,6.776910353068157,-93.22308964693184,-3.1276046626550738,-0.9676261807726149,-0.06314344543582706,31785278,1.0
2003,HD,1574748000000,220.76,220.96,218.39,218.76,9988417,2.359999999999985,0.0,2.359999999999985,32.06662829352652,216.88,239.3091,17.298955374937,-82.701044625063,-3.35738047432892,-1.4455770394838763,-0.05979557069846686,41773695,1.0
2004,HD,1574834400000,223.0,223.4496,220.66400000000002,221.68,6691487,2.240000000000009,0.0,2.240000000000009,40.433448657802124,216.88,239.3091,27.285981158405836,-72.71401884159417,-3.320454053568227,-1.8205524423007466,-0.05728175861340101,48465182,1.0
2005,HD,1575007200000,220.51,223.33,220.29,223.3,2952948,-2.490000000000009,2.490000000000009,0.0,34.91750617831953,216.88,239.3091,16.18433196160343,-83.81566803839658,-3.452315643529886,-2.1469050825465748,-0.07071515866661049,45512234,-1.0
2006,HD,1575266400000,217.62,221.19,217.46,220.9,4428499,-2.8899999999999864,2.8899999999999864,0.0,29.523691667199685,216.88,239.3091,3.29928530346741,-96.70071469653259,-3.746824688160501,-2.46688900366936,-0.08888423696880887,41083735,-1.0
2007,HD,1575352800000,214.0,216.45,212.9305,216.45,6734092,-3.6200000000000045,3.6200000000000045,0.0,24.13524960254537,212.9305,239.3091,4.054422903414149,-95.94557709658585,-4.22364146457295,-2.818239495850078,-0.05251040467546275,34349643,-1.0
2008,HD,1575439200000,214.1,214.96,213.19,213.5,4256397,0.09999999999999432,0.0,0.09999999999999432,24.574035604804195,212.9305,239.3091,4.433518079048922,-95.56648192095108,-4.5411059878069295,-3.162812794241449,-0.03078315980081492,38606040,1.0
2009,HD,1575525600000,213.0,214.5,211.7701,214.36,4581409,-1.0999999999999943,1.0999999999999943,0.0,22.893435835645406,211.7701,239.3091,4.466029993826889,-95.5339700061731,-4.825830546035178,-3.4954163446001956,-0.025350050334034924,34024631,-1.0
2010,HD,1575612000000,214.28,215.3595,213.9,214.21,4194211,1.2800000000000011,0.0,1.2800000000000011,29.37816722966069,211.7701,239.3091,9.1139838047859,-90.8860161952141,-4.891801860361795,-3.7746934477525156,-0.017199467963124326,38218842,1.0
2011,HD,1575871200000,216.53,217.88,214.18,214.29,5149564,2.25,0.0,2.25,39.669224664700394,211.7701,233.12,22.294718008046825,-77.70528199195317,-4.708254578305883,-3.9614056738631893,-0.008562271062271032,43368406,1.0
2012,HD,1575957600000,215.9,216.69,215.1,216.52,4664413,-0.6299999999999955,0.6299999999999955,0.0,37.88560919268518,211.7701,225.0,31.216411310743062,-68.78358868925693,-4.561050815118961,-4.0813347021143445,-0.022014857764087625,38703993,-1.0
2013,HD,1576044000000,212.0,213.65,210.61,211.03,8286340,-3.9000000000000057,3.9000000000000057,0.0,28.676050506802497,210.61,223.4496,10.82588242624371,-89.17411757375629,-4.704853555469725,-4.206038472785421,-0.04932735426008972,30417653,-1.0
2014,HD,1576130400000,212.04,214.13,210.73,212.5,9916525,0.03999999999999204,0.0,0.03999999999999204,28.880645800811095,210.61,223.4496,11.137418611171528,-88.86258138882847,-4.760712072206417,-4.316973192669621,-0.038410956419209996,40334178,1.0
2015,HD,1576216800000,214.08,214.23,210.67,212.12,6870348,2.0400000000000205,0.0,2.0400000000000205,39.15193811026538,210.61,223.4496,27.02576404249355,-72.97423595750645,-4.58748769560745,-4.371076093257186,-0.0162668872346291,47204526,1.0
1021,IBM,1514959200000,158.49,159.81,156.33,157.34,9441567,4.240000000000009,0.0,4.240000000000009,82.05845894372334,151.49,159.81,84.13461538461546,-15.865384615384546,0.37670700394201617,-0.12391668475961766,0.0343274815636625,7017837,1.0
1022,IBM,1515045600000,161.7,162.3237,159.37,159.65,7556249,3.2099999999999795,0.0,3.2099999999999795,87.76245821890828,151.49,162.3237,94.2429640842924,-5.757035915707599,0.7806829517633389,0.05700324254497371,0.05720823798626995,14574086,1.0
1023,IBM,1515132000000,162.49,162.9,161.101,162.44,5195764,0.7900000000000205,0.0,0.7900000000000205,88.77577674010342,151.49,162.9,96.40666082383876,-3.593339176161233,1.1253183104267919,0.27066625612133743,0.07254125412541268,19769850,1.0
1024,IBM,1515391200000,163.47,163.905,161.701,162.66,5237523,0.9799999999999898,0.0,0.9799999999999898,89.96512894136265,151.49,163.905,96.49617398308496,-3.5038260169150424,1.4348325655920178,0.5034995180154735,0.0719344262295083,25007373,1.0
1025,IBM,1515477600000,163.83,164.53,163.06,163.9,4341810,0.36000000000001364,0.0,0.36000000000001364,90.39645917709511,151.49,164.53,94.63190184049088,-5.368098159509119,1.6769540822023714,0.7381904308528532,0.07197539750049065,29349183,1.0
1026,IBM,1515564000000,164.18,164.33,162.5,162.91,4174105,0.3499999999999943,0.0,0.3499999999999943,90.83822409243945,151.49,164.53,97.31595092024544,-2.6840490797545593,1.8650817013443088,0.9635686849511443,0.07216090903154182,33523288,1.0
1027,IBM,1515650400000,164.2,164.94,163.3,164.8,3794453,0.01999999999998181,0.0,0.01999999999998181,90.86592756079709,151.49,164.94,94.49814126394045,-5.501858736059552,1.9888778127602507,1.1686305105129657,0.06595689431316543,37317741,1.0
1028,IBM,1515736800000,163.14,164.74,163.03,164.02,5031886,-1.0600000000000023,1.0600000000000023,0.0,76.68543982760661,151.5,164.94,86.60714285714278,-13.392857142857228,1.9905596723095869,1.33301634287229,0.06335549472037538,32285855,-1.0
1029,IBM,1516082400000,163.85,165.29,163.35,165.1,7794195,0.710000000000008,0.0,0.710000000000008,79.19479684832231,152.5,165.29,88.74120406567631,-11.25879593432368,2.015767694731778,1.4695666132441878,0.062236628849270614,40080050,1.0
1030,IBM,1516168800000,168.65,169.1253,167.26,168.01,11710033,4.800000000000011,0.0,4.800000000000011,88.69028961853037,152.61,169.1253,97.12206257228144,-2.8779374277185665,2.337522720762024,1.6431578347477553,0.06410499085115773,51790083,1.0
1031,IBM,1516255200000,169.12,171.13,168.15,170.0,14259345,0.46999999999999886,0.0,0.46999999999999886,89.24487150091852,153.2,171.13,88.78973786949253,-11.210262130507473,2.592143487443252,1.832954965286855,0.04588744588744609,66049428,1.0
1032,IBM,1516341600000,162.37,165.4,161.3,164.46,21172488,-6.75,6.75,0.0,49.236280714488245,153.415,171.13,50.550381033022916,-49.44961896697708,2.290503879733535,1.9244647481761912,-0.0007385069850452952,44876940,-1.0
1033,IBM,1516600800000,162.6,163.98,161.11,161.51,8480795,0.22999999999998977,0.0,0.22999999999998977,50.1155206381213,153.54,171.13,51.50653780557135,-48.49346219442865,2.0449996133992556,1.9485717212208045,-0.005322077445402806,53357735,1.0
1034,IBM,1516687200000,166.25,166.26,162.51,162.82,7466232,3.6500000000000057,0.0,3.6500000000000057,62.12700230187169,156.33,171.13,67.02702702702702,-32.97297297297298,2.088540572801975,1.9765654915370388,0.014771409387779988,60823967,1.0
1035,IBM,1516773600000,165.37,168.72,164.82,166.75,5645003,-0.8799999999999955,0.8799999999999955,0.0,58.22676092980426,159.37,171.13,51.020408163265344,-48.979591836734656,2.0352238368024587,1.988297160590123,0.007248142282860304,55178964,-1.0
1036,IBM,1516860000000,165.47,166.78,165.19,165.91,3302520,0.09999999999999432,0.0,0.09999999999999432,58.56780792836008,161.101,171.13,43.56366537042578,-56.436334629574226,1.977164743516198,1.9860706771753383,0.007734470158343498,58481484,1.0
1037,IBM,1516946400000,167.34,167.4142,165.79,166.12,3787913,1.8700000000000045,0.0,1.8700000000000045,64.77331614981364,161.11,171.13,62.17564870259482,-37.82435129740518,2.044710669934176,1.9977986757271062,0.025744759102611425,62269397,1.0
1038,IBM,1517205600000,166.8,168.39,166.01,167.45,3516995,-0.539999999999992,0.539999999999992,0.0,61.69448516563157,161.11,171.13,56.786427145708664,-43.213572854291336,2.034281713023603,2.0050952831864057,0.01800427220018319,58752402,-1.0
1039,IBM,1517292000000,163.62,166.77,163.155,166.21,4902341,-3.180000000000007,3.180000000000007,0.0,46.6330906844207,161.11,171.13,25.049900199600756,-74.95009980039924,1.768519466698507,1.957780119888826,-0.02982508152979546,53850061,-1.0
1040,IBM,1517378400000,163.7,164.99,162.761,163.75,4072830,0.07999999999998408,0.0,0.07999999999998408,47.00861226977425,161.11,171.13,25.848303393213367,-74.15169660678663,1.5462895228164086,1.8754820004743429,-0.03204824976348164,57922891,1.0
1041,IBM,1517464800000,162.4,164.13,161.9,163.19,4434242,-1.299999999999983,1.299999999999983,0.0,41.529381532967825,161.11,171.13,12.87425149700593,-87.12574850299407,1.257897911247852,1.7519651826290448,0.00018476319517146678,53488649,-1.0
1042,IBM,1517551200000,159.03,162.0,158.8663,161.7,5251938,-3.3700000000000045,3.3700000000000045,0.0,30.793537441613054,158.8663,171.13,1.334833696192876,-98.66516630380713,0.7656385259254535,1.5546998512883266,-0.021955719557195552,48236711,-1.0
1043,IBM,1517810400000,152.53,158.5,150.0,157.89,8746599,-6.5,6.5,0.0,19.547437673011828,150.0,171.13,11.973497397065792,-88.02650260293422,-0.11703434895702003,1.2203530112392573,-0.08252631578947367,39490112,-1.0
1044,IBM,1517896800000,155.34,155.49,149.11,150.29,9867678,2.8100000000000023,0.0,2.8100000000000023,31.94516802337168,149.11,171.13,28.292461398728406,-71.7075386012716,-0.5940217572988615,0.8574780575316335,-0.06065187156074259,49357790,1.0
1045,IBM,1517983200000,153.85,155.34,153.28,154.17,6149207,-1.490000000000009,1.490000000000009,0.0,29.19280342080573,149.11,168.72,24.171341152473147,-75.82865884752685,-1.0734362844349334,0.47129518913832,-0.07022420982655464,43208583,-1.0
1046,IBM,1518069600000,147.59,153.16,147.5,152.48,6779095,-6.259999999999991,6.259999999999991,0.0,20.592052152728385,147.5,168.72,0.42412818096137334,-99.57587181903862,-1.9128451179211652,-0.005532872273577152,-0.11802318632723796,36429488,-1.0
1047,IBM,1518156000000,149.51,150.54,144.3955,148.6,7828290,1.9199999999999875,0.0,1.9199999999999875,28.089722664516515,144.3955,168.72,21.026125922423862,-78.97387407757613,-2.4012304572464984,-0.4846723892681616,-0.10365707434052773,44257778,1.0
1048,IBM,1518415200000,151.4,152.4,150.3,150.9,5881377,1.8900000000000148,0.0,1.8900000000000148,35.05468378619355,144.3955,168.72,28.79606980616254,-71.20393019383746,-2.611143389142967,-0.9099665892431229,-0.07468524630240803,50139155,1.0
1049,IBM,1518501600000,150.75,151.179,149.64,150.9,4891010,-0.6500000000000057,0.6500000000000057,0.0,33.75722396687955,144.3955,168.39,26.483152389089188,-73.51684761091082,-2.7955018958644473,-1.2870736505673879,-0.07910812461820393,45248145,-1.0
1050,IBM,1518588000000,154.76,155.0,150.0,150.19,5479033,4.009999999999991,0.0,4.009999999999991,47.570646300466706,144.3955,168.39,43.19531559315676,-56.80468440684324,-2.5987158958751593,-1.5494020996289424,-0.04704433497536953,50727178,1.0
1051,IBM,1518674400000,156.01,156.86,153.7,155.5,5623581,1.25,0.0,1.25,51.228626102399794,144.3955,168.39,48.4048427764696,-51.5951572235304,-2.31826914136812,-1.7031755079767783,-0.018990127648871313,56350759,1.0
1052,IBM,1518760800000,156.18,157.7905,155.69,155.71,4282908,0.17000000000001592,0.0,0.17000000000001592,51.75681538249015,144.3955,166.77,52.66933339292499,-47.330666607075,-2.0589541097726,-1.774331228335943,0.023929718743853634,60633667,1.0
1053,IBM,1519106400000,155.16,155.96,153.87,155.79,4489604,-1.0200000000000102,1.0200000000000102,0.0,48.146938216013744,144.3955,164.99,52.26880963364001,-47.73119036635999,-1.9115035176738218,-1.8017656862035187,-0.0011587485515643925,56144063,-1.0
1054,IBM,1519192800000,153.96,156.79,153.9,155.43,3728571,-1.1999999999999886,1.1999999999999886,0.0,43.982698423128554,144.3955,164.13,48.465884618308095,-51.534115381691905,-1.8675042242753932,-1.8149133938178938,0.0007149821254468502,52415492,-1.0
1055,IBM,1519279200000,153.18,155.04,152.79,154.5,4024627,-0.7800000000000011,0.7800000000000011,0.0,41.303440359660165,144.3955,162.0,49.89917350677388,-50.10082649322612,-1.872471928415763,-1.8264251007374679,0.03787519479639534,48390865,-1.0
1056,IBM,1519365600000,155.52,155.855,154.07,154.3,3256074,2.3400000000000034,0.0,2.3400000000000034,51.52504836083478,144.3955,158.5,78.87199120847964,-21.12800879152036,-1.6722682107048001,-1.7955937227309344,0.04019798006822306,51646939,1.0
1057,IBM,1519624800000,158.58,158.88,155.51,155.81,3610292,3.0600000000000023,0.0,3.0600000000000023,61.61191903742877,144.3955,158.88,97.92882046325394,-2.0711795367460595,-1.2570716093218266,-1.687889300049113,0.04742404227212682,55257231,1.0
1058,IBM,1519711200000,156.55,159.78,156.53,158.46,4237283,-2.030000000000001,2.030000000000001,0.0,53.146705213995105,144.3955,159.78,79.0048425363191,-20.995157463680908,-1.0764759824631653,-1.5656066365319237,0.038474295190713104,51019948,-1.0
1059,IBM,1519797600000,155.83,158.1399,155.8,157.5,3803512,-0.7199999999999989,0.7199999999999989,0.0,50.31742495573196,144.3955,159.78,74.32480743605585,-25.67519256394415,-0.9791826481923636,-1.4483218388640118,0.006913931248384797,47216436,-1.0
1060,IBM,1519884000000,153.81,156.9742,152.79,155.53,4039339,-2.0200000000000102,2.0200000000000102,0.0,42.920791098130636,144.3955,159.78,61.194708960317215,-38.805291039682785,-1.050395363510745,-1.3687365437933585,-0.014101660149990258,43177097,-1.0
1061,IBM,1519970400000,154.49,154.76,151.88,152.79,3261141,0.6800000000000068,0.0,0.6800000000000068,46.00386434922044,149.64,159.78,47.830374753451835,-52.169625246548165,-1.0407221396361876,-1.3031336629619243,-0.01082084773978742,46438238,1.0
1062,IBM,1520229600000,156.95,157.49,153.75,154.12,3670630,2.4599999999999795,0.0,2.4599999999999795,55.93826355078565,149.64,159.78,72.09072978303739,-27.909270216962607,-0.8276642830491028,-1.2080397869793602,0.011536478473833434,50108868,1.0
1063,IBM,1520316000000,155.72,157.89,155.1568,157.28,3685736,-1.2299999999999898,1.2299999999999898,0.0,50.5704920711891,150.0,159.78,58.48670756646215,-41.51329243353785,-0.7482141741823511,-1.1160746644199584,0.011431540659911699,46423132,-1.0
1064,IBM,1520402400000,158.32,158.83,154.73,155.0,4607677,2.5999999999999943,0.0,2.5999999999999943,59.94516505954637,151.88,159.78,81.51898734177206,-18.481012658227936,-0.47242461685121384,-0.9873446549062095,0.033555294424859605,51030809,1.0
1065,IBM,1520488800000,156.21,159.57,155.07,159.0,6455612,-2.109999999999985,2.109999999999985,0.0,50.90480668564968,151.88,159.78,54.8101265822786,-45.1898734177214,-0.4175089286841853,-0.8733775096618046,0.0044367283950617065,44575197,-1.0
1066,IBM,1520575200000,159.31,159.5825,157.3,157.47,5022238,3.0999999999999943,0.0,3.0999999999999943,60.90081001467854,151.88,159.78,94.05063291139243,-5.949367088607576,-0.124881667074078,-0.7236783411442593,0.004603354773615731,49597435,1.0
1067,IBM,1520830800000,160.26,161.02,158.87,159.64,5063497,0.9499999999999886,0.0,0.9499999999999886,63.52667612949215,151.88,161.02,91.68490153172847,-8.315098468271533,0.18086777141260768,-0.5427691186328859,0.023698498882146257,54660932,1.0
1068,IBM,1520917200000,159.32,162.1122,158.81,160.09,4185590,-0.9399999999999977,0.9399999999999977,0.0,59.0026172325715,151.88,162.1122,72.71163581634443,-27.288364183655585,0.34397348371769,-0.36542059816277067,0.022396200988256343,50475342,-1.0
1069,IBM,1521003600000,158.12,160.68,157.74,160.17,3631825,-1.1999999999999886,1.1999999999999886,0.0,53.40089053333339,151.88,162.1122,60.98395262015994,-39.01604737984006,0.3728504648007913,-0.21776638557005826,0.028021585072492083,46843517,-1.0
1070,IBM,1521090000000,159.61,161.25,158.52,158.71,3870595,1.490000000000009,0.0,1.490000000000009,58.98038836624949,151.88,162.1122,75.54582592208922,-24.454174077910775,0.5092130328562519,-0.0723705018847962,0.03314130364424894,50714112,1.0
1071,IBM,1521176400000,160.26,161.98,159.64,160.06,9262656,0.6499999999999773,0.0,0.6499999999999773,61.31206358213789,151.88,162.1122,81.89832098668899,-18.101679013311013,0.6617325440771538,0.07445010730759384,0.021089518955081266,59976768,1.0
1072,IBM,1521435600000,157.35,159.8899,156.45,159.71,5481983,-2.9099999999999966,2.9099999999999966,0.0,47.39527328664559,151.88,162.1122,53.45868923594139,-46.5413107640586,0.5429821420780172,0.16815651426167857,0.010467505779604425,54494785,-1.0
1073,IBM,1521522000000,156.2,157.93,155.29,157.52,4336738,-1.1500000000000057,1.1500000000000057,0.0,42.949901582133975,151.88,162.1122,42.21965950626444,-57.78034049373555,0.352550588592095,0.2050353291277619,-0.013390601313794881,50158047,-1.0
1074,IBM,1521608400000,156.69,158.2,155.92,156.57,3482184,0.4900000000000091,0.0,0.4900000000000091,45.464665258190124,151.88,162.1122,47.00846347803991,-52.99153652196009,0.23822086704518597,0.21167243671124675,0.0030727866333781773,53640231,1.0
1075,IBM,1521694800000,152.09,155.2499,152.0,155.0,4746349,-4.599999999999994,4.599999999999994,0.0,30.771872259740647,152.0,162.1122,0.8900140424438143,-99.10998595755619,-0.2191965886015339,0.1254986316486906,-0.04532044441654637,48893882,-1.0
1076,IBM,1521781200000,148.89,152.58,148.541,152.25,4440883,-3.200000000000017,3.200000000000017,0.0,24.43375082021592,148.541,162.1122,2.5716222589011246,-97.42837774109887,-0.8291486107645198,-0.06543081683395155,-0.07094721078247845,44452999,-1.0
1077,IBM,1522040400000,153.37,153.657,150.28,151.21,4103904,4.480000000000018,0.0,4.480000000000018,43.299350391215334,148.541,162.1122,35.58270455081353,-64.41729544918647,-0.9416886994775098,-0.24068239336266326,-0.03734622144112476,48556903,1.0
1078,IBM,1522126800000,151.91,154.8697,151.16,153.95,3883745,-1.460000000000008,1.460000000000008,0.0,39.58333208703433,148.541,162.1122,24.824628625324205,-75.17537137467579,-1.1351269664465349,-0.41957130797943765,-0.03927396913736403,44673158,-1.0
1079,IBM,1522213200000,152.52,153.86,151.89,152.07,3664826,0.6100000000000136,0.0,0.6100000000000136,41.983665847749286,148.541,162.1122,29.319441169535576,-70.68055883046442,-1.2252466136485793,-0.580706369113266,-0.04442077564062408,48337984,1.0
1080,IBM,1522299600000,153.43,153.89,151.08,153.07,3419959,0.9099999999999966,0.0,0.9099999999999966,45.697273066439394,148.541,162.1122,36.02481726008023,-63.97518273991977,-1.2095318358896066,-0.7064714624685342,-0.042618245351303985,51757943,1.0
1081,IBM,1522645200000,150.07,153.38,148.43,153.34,5150435,-3.3600000000000136,3.3600000000000136,0.0,35.90565740895242,148.43,162.1122,11.98637645992594,-88.01362354007406,-1.4506261407645695,-0.8553023981277414,-0.04626628535112809,46607508,-1.0
1082,IBM,1522731600000,149.85,151.0,148.3,150.8,4135696,-0.21999999999999886,0.21999999999999886,0.0,35.33367302858021,148.3,161.98,11.33040935672504,-88.66959064327496,-1.6404704328656976,-1.0123360050753327,-0.040653008962868054,42471812,-1.0
1083,IBM,1522818000000,154.12,154.47,147.45,147.89,4805261,4.27000000000001,0.0,4.27000000000001,52.33763069050102,147.45,161.98,45.905024088093704,-54.094975911906296,-1.4307862613849807,-1.0960260563372624,-0.016401812496011137,47277073,1.0
1084,IBM,1522904400000,154.03,154.92,153.34,154.44,3185388,-0.09000000000000341,0.09000000000000341,0.0,52.00506304977692,147.45,161.98,45.28561596696498,-54.71438403303501,-1.2573590831379704,-1.128292661697404,0.012755605233743195,44091685,-1.0
1085,IBM,1522990800000,150.57,153.95,149.54,153.46,3672919,-3.460000000000008,3.460000000000008,0.0,40.569715069813014,147.45,159.8899,25.080587464529447,-74.91941253547056,-1.3825305985004945,-1.1791402490580223,0.01128349788434413,40418766,-1.0
1086,IBM,1523250000000,152.69,154.66,151.7433,151.8,4413178,2.1200000000000045,0.0,2.1200000000000045,48.56557719764894,147.45,158.2,48.744186046511714,-51.255813953488286,-1.296078709934818,-1.2025279412333816,-0.0044337223707374696,44831944,1.0
1087,IBM,1523336400000,155.39,156.605,154.75,155.03,3955952,2.6999999999999886,0.0,2.6999999999999886,57.05610562696567,147.45,158.2,73.86046511627904,-26.13953488372095,-0.9986120782886871,-1.1617447686444426,0.022908300967678263,48787896,1.0
1088,IBM,1523422800000,155.36,155.78,153.88,154.37,3306539,-0.029999999999972715,0.029999999999972715,0.0,56.93561029362021,147.45,156.605,86.40087383943226,-13.599126160567735,-0.7565650224494789,-1.08070881940545,0.01862050878573296,45481357,-1.0
1089,IBM,1523509200000,158.07,158.98,156.67,156.75,5639444,2.7099999999999795,0.0,2.7099999999999795,64.70485814854987,147.45,158.98,92.10754553339119,-7.8924544666088154,-0.3424895673229287,-0.9330649689889456,0.030241804080036516,51120801,1.0
1090,IBM,1523595600000,156.71,159.22,155.91,158.67,4057058,-1.3599999999999852,1.3599999999999852,0.0,58.58470294119064,147.45,159.22,78.67459643160586,-21.325403568394126,-0.12249463404768335,-0.7709509020006932,0.04424601852468868,47063743,-1.0
1091,IBM,1523854800000,157.89,159.14,157.67,157.99,4186755,1.1799999999999784,0.0,1.1799999999999784,62.16719392856062,147.45,159.22,88.70008496176712,-11.299915038232891,0.14525392821153105,-0.5877099359582484,0.0536536536536536,51250498,1.0
1092,IBM,1523941200000,160.91,162.0,158.51,158.82,10207534,3.0200000000000102,0.0,3.0200000000000102,69.86501973886799,147.45,162.0,92.50859106529208,-7.491408934707922,0.593958018322013,-0.35137634510219606,0.04405657928886586,61458032,1.0
1093,IBM,1524027600000,148.79,152.63,148.26,152.14,20381695,-12.120000000000005,12.120000000000005,0.0,35.97210330617516,147.45,162.0,9.209621993127163,-90.79037800687284,-0.02690736263087956,-0.28648254860793276,-0.03401934688047792,41076337,-1.0
1094,IBM,1524114000000,147.7,149.2072,146.62,149.19,8086056,-1.0900000000000034,1.0900000000000034,0.0,34.248026949494374,146.62,162.0,7.022106631989495,-92.9778933680105,-0.5998780397168559,-0.34916164682971745,-0.019060901906090222,32990281,-1.0
1095,IBM,1524200400000,144.9,147.97,144.51,147.9,8265643,-2.799999999999983,2.799999999999983,0.0,29.987954822034027,144.51,162.0,2.2298456260721244,-97.77015437392788,-1.2650673396751415,-0.5323427853988024,-0.05101840330080554,24724638,-1.0
1096,IBM,1524459600000,145.86,145.96,144.33,145.03,5315625,0.960000000000008,0.0,0.960000000000008,33.27157833361555,144.33,162.0,8.658743633276753,-91.34125636672324,-1.695295509505513,-0.7649333302201446,-0.061329557886607766,30040263,1.0
1097,IBM,1524546000000,145.56,147.3,144.53,146.51,4916476,-0.30000000000001137,0.30000000000001137,0.0,32.7182679435993,144.33,162.0,6.960950764006737,-93.03904923599326,-2.0369521807415936,-1.0193371003244347,-0.0630792996910402,25123787,-1.0
1098,IBM,1524632400000,145.94,146.4,144.111,145.79,7326379,0.37999999999999545,0.0,0.37999999999999545,34.31478404463128,144.111,162.0,10.22416009838452,-89.77583990161548,-2.251124838904076,-1.265694648040363,-0.0767381539824128,32450166,1.0
1099,IBM,1524718800000,146.72,147.36,146.2,146.6,4265812,0.7800000000000011,0.0,0.7800000000000011,37.80985976123672,144.111,162.0,14.584381463469212,-85.41561853653079,-2.3310915233668936,-1.4787740231056694,-0.06374832493140203,36715978,1.0
1100,IBM,1524805200000,146.48,147.25,145.66,146.84,3205482,-0.2400000000000091,0.2400000000000091,0.0,37.10883901695456,144.111,162.0,13.24277488959695,-86.75722511040304,-2.386306067419838,-1.6602804319685034,-0.07226550129837228,33510496,-1.0
1101,IBM,1525064400000,144.96,147.38,144.96,146.86,4415533,-1.5199999999999818,1.5199999999999818,0.0,32.68091406931548,144.111,162.0,4.745933255073047,-95.25406674492696,-2.5235399304843043,-1.832932331671664,-0.0991237337642159,29094963,-1.0
1102,IBM,1525150800000,145.0,145.02,143.47,144.65,4433393,0.03999999999999204,0.0,0.03999999999999204,32.92394118399844,143.47,162.0,8.25688073394496,-91.74311926605505,-2.5991083744159766,-1.9861675402205266,-0.02547214194502312,33528356,1.0
1103,IBM,1525237200000,142.45,144.82,142.07,144.46,5194917,-2.5500000000000114,2.5500000000000114,0.0,26.01554111619261,142.07,162.0,1.9066733567485967,-98.0933266432514,-2.83199369296716,-2.1553327707698537,-0.03554502369668244,28333439,-1.0
1104,IBM,1525323600000,141.99,142.23,139.9,142.13,5018592,-0.45999999999997954,0.45999999999997954,0.0,24.926864551089324,139.9,162.0,9.457013574660651,-90.54298642533935,-3.018851848933906,-2.328036586402664,-0.0200828157349896,23314847,-1.0
1105,IBM,1525410000000,143.91,144.35,140.28,141.1,4402170,1.9199999999999875,0.0,1.9199999999999875,37.519142369344465,139.9,162.0,18.14479638009046,-81.85520361990953,-2.977757158270606,-2.4579807007762526,-0.013368983957219416,27717017,1.0
1106,IBM,1525669200000,143.22,144.32,142.6403,144.0,3657009,-0.6899999999999977,0.6899999999999977,0.0,35.079275519556845,139.9,152.63,26.08012568735268,-73.91987431264732,-2.966641219950702,-2.559712804611143,-0.01607584501236603,24060008,-1.0
1107,IBM,1525755600000,143.0,143.507,142.06,143.0,5369119,-0.21999999999999886,0.21999999999999886,0.0,34.25964599930202,139.9,149.2072,33.30754684545294,-66.69245315454705,-2.9416644483379457,-2.6361031333565035,-0.020145265177470173,18690889,-1.0
1108,IBM,1525842000000,142.61,143.02,141.28,141.9,4195953,-0.38999999999998636,0.38999999999998636,0.0,32.696985878550734,139.9,147.97,33.58116480793073,-66.41883519206927,-2.919669427728138,-2.6928163922308306,-0.028012540894220228,14494936,-1.0
1109,IBM,1525928400000,144.24,144.33,143.01,143.15,3726608,1.6299999999999955,0.0,1.6299999999999955,44.83198890978682,139.9,147.38,58.02139037433167,-41.97860962566832,-2.7391809734856736,-2.7020893084817996,-0.015292190060076316,18221544,1.0
1110,IBM,1526014800000,144.14,144.85,143.58,144.11,3073167,-0.10000000000002274,0.10000000000002274,0.0,44.266992492158636,139.9,147.38,56.684491978609444,-43.315508021390556,-2.5745303531901698,-2.676577517423474,-0.005656732891832328,15148377,-1.0
1111,IBM,1526274000000,144.3,145.12,144.14,144.47,3216062,0.160000000000025,0.0,0.160000000000025,45.534204924755365,139.9,147.38,58.823529411764866,-41.176470588235134,-2.4034306708160784,-2.621948148101995,-0.004827586206896495,18364439,1.0
1112,IBM,1526360400000,143.74,143.99,142.92,143.5,4089397,-0.5600000000000023,0.5600000000000023,0.0,41.704738233195314,139.9,147.38,51.336898395722045,-48.663101604277955,-2.286647440217081,-2.554888006525012,0.009055809055809272,14275042,-1.0
1113,IBM,1526446800000,144.63,145.0275,143.27,143.7,3168659,0.8899999999999864,0.0,0.8899999999999864,49.4939549437701,139.9,147.38,63.235294117647015,-36.76470588235299,-2.098112873375726,-2.463532979895155,0.018592858652017652,17443701,1.0
1114,IBM,1526533200000,144.5,145.19,143.77,144.5,3147659,-0.12999999999999545,0.12999999999999545,0.0,48.403915344905656,139.9,147.38,61.497326203208566,-38.502673796791434,-1.936857819247507,-2.3581979477656256,0.004099784587589417,14296042,-1.0
1115,IBM,1526619600000,144.08,144.94,143.99,144.47,2682243,-0.4199999999999875,0.4199999999999875,0.0,44.731456005360286,139.9,145.19,79.01701323251442,-20.982986767485574,-1.8219421233719686,-2.2509467828868943,0.006004747940231869,11613799,-1.0
1116,IBM,1526878800000,145.49,146.04,144.68,144.95,2894698,1.4099999999999966,0.0,1.4099999999999966,57.28518529306044,139.9,146.04,91.04234527687322,-8.957654723126778,-1.5986902413258406,-2.1204954745746836,0.017412587412587444,14508497,1.0
1117,IBM,1526965200000,145.09,146.204,145.0,145.52,2284020,-0.4000000000000057,0.4000000000000057,0.0,53.3207632826466,139.9,146.204,82.32868020304562,-17.67131979695438,-1.4374615641894763,-1.9838886924976422,0.017390084846784948,12224477,-1.0
1118,IBM,1527051600000,144.67,144.7,143.48,144.35,3459747,-0.4200000000000159,0.4200000000000159,0.0,49.195951581178,140.28,146.204,74.10533423362563,-25.894665766374388,-1.3282594941905472,-1.8527628528362234,0.002981142540210646,8764730,-1.0
1119,IBM,1527138000000,144.07,144.48,142.95,144.39,3398701,-0.5999999999999943,0.5999999999999943,0.0,43.63223388923794,141.28,146.204,56.66125101543437,-43.33874898456563,-1.275420454005456,-1.73729437307007,-0.00048563896212006075,5366029,-1.0
1120,IBM,1527224400000,143.64,144.57,143.46,143.9,4914294,-0.4300000000000068,0.4300000000000068,0.0,39.90074748503717,141.28,146.204,47.92851340373643,-52.07148659626356,-1.2537840255482138,-1.6405923035656989,-0.004573804573804741,451735,-1.0
1121,IBM,1527570000000,141.22,142.89,140.21,142.53,4537638,-2.4199999999999875,2.4199999999999875,0.0,25.65381870294678,140.21,146.204,16.85018351685003,-83.14981648314996,-1.415564654464589,-1.5955867737454772,-0.017531654375956607,-4085903,-1.0
1122,IBM,1527656400000,142.62,143.1,141.82,141.9,5118530,1.4000000000000057,0.0,1.4000000000000057,39.96313289236474,140.21,146.204,40.206873540206814,-59.79312645979318,-1.4145174496835011,-1.5593729089330821,-0.01389753163244134,1032627,1.0
1123,IBM,1527742800000,141.31,142.81,141.05,142.81,6830256,-1.3100000000000023,1.3100000000000023,0.0,33.0874660024635,140.21,146.204,18.351685018351592,-81.64831498164841,-1.502065358342918,-1.5479113988150495,-0.022076124567473987,-5797629,-1.0
1124,IBM,1527829200000,141.95,142.84,141.62,142.43,3857530,0.6399999999999864,0.0,0.6399999999999864,39.00332789817123,140.21,146.204,29.029029029028706,-70.9709709709713,-1.5024907443715847,-1.5388272679263566,-0.014783453636868615,-1940099,1.0
1125,IBM,1528088400000,143.04,143.17,142.18,142.3,3035257,1.0900000000000034,0.0,1.0900000000000034,48.03230293341461,140.21,146.204,47.21388054721361,-52.78611945278639,-1.398758946019825,-1.5108136035450506,-0.016839645336449327,1095158,1.0
1126,IBM,1528174800000,143.7,144.08,143.04,143.05,2836017,0.6599999999999966,0.0,0.6599999999999966,52.902997765898725,140.21,146.204,58.22489155822457,-41.77510844177543,-1.248902748127108,-1.4584314324614622,-0.009580260527948248,3931175,1.0
1127,IBM,1528261200000,144.71,144.72,143.54,144.34,3220139,1.0100000000000193,0.0,1.0100000000000193,59.59053078799667,140.21,146.204,75.07507507507508,-24.92492492492492,-1.0366989614738884,-1.3740849382639475,0.00027649132508478225,7151314,1.0
1128,IBM,1528347600000,145.36,146.7,144.93,145.0,4316484,0.6500000000000057,0.0,0.6500000000000057,63.444958022617875,140.21,146.7,79.35285053929154,-20.64714946070846,-0.8067807172220682,-1.2606240940555717,0.008953980703824582,11467798,1.0
1129,IBM,1528434000000,146.14,146.43,144.37,145.0,5210468,0.7799999999999727,0.0,0.7799999999999727,67.70957142484302,140.21,146.7,91.37134052388284,-8.628659476117164,-0.5552339338215972,-1.119546062008777,0.017404622667780645,16678266,1.0
1130,IBM,1528693200000,146.58,147.41,146.14,146.62,3259986,0.44000000000002615,0.0,0.44000000000002615,69.98847731866422,140.21,147.41,88.47222222222243,-11.527777777777574,-0.31672858754052413,-0.9589825671151263,0.03795496388613517,19938252,1.0
1131,IBM,1528779600000,146.87,147.52,146.62,147.1,2640515,0.28999999999999204,0.0,0.28999999999999204,71.51719927078874,140.21,147.52,91.10807113543085,-8.891928864569158,-0.10312374193227924,-0.7878108020785569,0.029799467115411593,22578767,1.0
1132,IBM,1528866000000,146.35,147.47,146.2,146.79,2968180,-0.5200000000000102,0.5200000000000102,0.0,64.69869318355182,140.21,147.52,83.99452804377545,-16.00547195622456,0.023926633859900903,-0.6254633148908654,0.035666265657065876,19610587,-1.0
1133,IBM,1528952400000,145.2,146.98,145.09,146.65,3326343,-1.1500000000000057,1.1500000000000057,0.0,52.03836929479704,140.21,147.52,68.26265389876852,-31.737346101231477,0.03146212584812247,-0.4940782267430678,0.022895385699189807,16284244,-1.0
1134,IBM,1529038800000,145.39,145.47,143.7,144.9,9116048,0.18999999999999773,0.0,0.18999999999999773,53.76317805999169,140.21,147.52,70.86183310533484,-29.13816689466516,0.05216334561796998,-0.3848299122708602,0.016428970917225838,25400292,1.0
1135,IBM,1529298000000,144.48,144.52,143.14,144.18,4286406,-0.9099999999999966,0.9099999999999966,0.0,44.84978474300429,141.05,147.52,53.01391035548654,-46.98608964451346,-0.004801259706056271,-0.30882418175789944,0.00542797494780789,21113886,-1.0
1136,IBM,1529384400000,143.9,144.22,142.95,143.12,3487015,-0.5799999999999841,0.5799999999999841,0.0,39.97574353994199,141.05,147.52,44.049459041730984,-55.950540958269016,-0.09564261652042205,-0.26618786871040395,-0.0055974016999515985,17626871,-1.0
1137,IBM,1529470800000,142.63,144.52,142.41,144.22,3329917,-1.2700000000000102,1.2700000000000102,0.0,31.364111631092896,141.62,147.52,17.11864406779644,-82.88135593220356,-0.26703092023484487,-0.26635647901529214,-0.018780957622454686,14296954,-1.0
1138,IBM,1529557200000,141.25,143.14,140.83,142.59,3887650,-1.3799999999999955,1.3799999999999955,0.0,24.694356452352835,140.83,147.52,6.278026905829412,-93.72197309417058,-0.508347525064039,-0.31475468822504155,-0.033461064732448254,10409304,-1.0
1139,IBM,1529643600000,141.28,141.81,140.78,141.64,6013678,0.030000000000001137,0.0,0.030000000000001137,25.09391834051665,140.78,147.52,7.41839762611275,-92.58160237388725,-0.6892269079185667,-0.38964913216374664,-0.036157729567471764,16422982,1.0
1140,IBM,1529902800000,138.79,140.4,138.28,140.4,8937085,-2.490000000000009,2.490000000000009,0.0,16.63899566380408,138.28,147.52,5.519480519480416,-94.48051948051959,-1.0217128460553226,-0.5160618749420619,-0.05501463879621438,7485897,-1.0
1141,IBM,1529989200000,139.08,139.8499,138.33,139.36,4139455,0.29000000000002046,0.0,0.29000000000002046,20.24992363079953,138.28,147.52,8.658008658008773,-91.34199134199122,-1.2474307225776613,-0.6623356444691818,-0.04967543559958987,11625352,1.0
1142,IBM,1530075600000,137.48,139.78,137.45,139.11,4101828,-1.6000000000000227,1.6000000000000227,0.0,15.872874981027493,137.45,147.52,0.2979145978153036,-99.7020854021847,-1.537691029520289,-0.8374067214794034,-0.053168044077134935,7523524,-1.0
1143,IBM,1530162000000,140.04,140.54,137.945,138.1,4523666,2.5600000000000023,0.0,2.5600000000000023,39.86833588789937,137.45,147.52,25.719960278053605,-74.2800397219464,-1.5433681268793578,-0.9785990025593942,-0.03679757892564817,12047190,1.0
1144,IBM,1530248400000,139.7,141.359,139.61,140.32,3753684,-0.3400000000000034,0.3400000000000034,0.0,38.198675249666245,137.45,147.52,22.343594836146924,-77.65640516385308,-1.557349526034841,-1.0943491072544838,-0.033084163898117414,8293506,-1.0
1145,IBM,1530507600000,139.86,140.22,138.2,138.28,3405642,0.160000000000025,0.0,0.160000000000025,39.57278571227131,137.45,147.47,24.051896207585056,-75.94810379241494,-1.5377927284385464,-1.1830378314912964,-0.028075052119527433,11699148,1.0
1146,IBM,1530594000000,139.57,140.94,139.3678,140.65,1963232,-0.29000000000002046,0.29000000000002046,0.0,37.814427657123,137.45,146.98,22.24554039874086,-77.75445960125914,-1.5280791095497932,-1.252046087102996,-0.021454112038140627,9735916,-1.0
1147,IBM,1530766800000,141.43,141.43,139.93,140.48,3744730,1.8600000000000136,0.0,1.8600000000000136,53.2028194058761,137.45,145.47,49.625935162094926,-50.374064837905074,-1.354681478914415,-1.2725731654652799,0.0012743362831859617,13480646,1.0
1148,IBM,1530853200000,142.48,142.94,141.17,141.53,2910426,1.049999999999983,0.0,1.049999999999983,59.69881440787059,137.45,144.52,71.14568599717094,-28.854314002829057,-1.1196314786586186,-1.2419848281039476,0.00849377123442796,16391072,1.0
1149,IBM,1531112400000,144.39,144.72,142.47,142.59,3904652,1.9099999999999966,0.0,1.9099999999999966,68.79147874946483,137.45,144.72,95.46079779917453,-4.539202200825475,-0.7703540336936499,-1.1476586692218882,0.04034872829454561,20295724,1.0
1150,IBM,1531198800000,144.71,145.59,144.255,144.51,3776991,0.3200000000000216,0.0,0.3200000000000216,70.09575819536977,137.45,145.59,89.18918918918926,-10.810810810810736,-0.4623980117129065,-1.010606537720092,0.040480299108426765,24072715,1.0
1151,IBM,1531285200000,144.94,146.19,144.0,144.0,3526565,0.22999999999998977,0.0,0.22999999999998977,71.09750632121488,137.45,146.19,85.6979405034325,-14.302059496567491,-0.19750514948526643,-0.8479862600731267,0.05426243817282517,27599280,1.0
1152,IBM,1531371600000,146.45,146.83,145.74,145.85,3119505,1.509999999999991,0.0,1.509999999999991,76.94734308734124,137.45,146.83,95.94882729211062,-4.0511727078893705,0.1327369807729042,-0.6518416119039205,0.04577263638960294,30718785,1.0
1153,IBM,1531458000000,145.9,146.9799,145.8,146.45,3067638,-0.549999999999983,0.549999999999983,0.0,70.91507482059029,137.45,146.9799,88.66829662430895,-11.331703375691045,0.3460868693785244,-0.4522559156474315,0.044380816034359505,27651147,-1.0
1154,IBM,1531717200000,145.46,145.79,144.21,145.67,3468817,-0.4399999999999977,0.4399999999999977,0.0,66.12964343817805,137.45,146.9799,84.05124922612012,-15.948750773879883,0.4741979814384649,-0.2669651362302522,0.040040040040040026,24182330,-1.0
1155,IBM,1531803600000,143.49,145.0,143.34,144.75,5096741,-1.9699999999999989,1.9699999999999989,0.0,49.03528844305116,137.45,146.9799,63.37946882968365,-36.620531170316355,0.4120165993411149,-0.13116878911597873,0.028086264956652673,19085589,-1.0
1156,IBM,1531890000000,144.52,144.8,142.7351,143.51,6935288,1.0300000000000011,0.0,1.0300000000000011,55.91083622603431,137.945,146.9799,72.77335665032288,-27.226643349677122,0.44076808865457906,-0.016781413561867138,0.021848264158947917,26020877,1.0
1157,IBM,1531976400000,149.24,150.54,147.25,147.85,14655804,4.719999999999999,0.0,4.719999999999999,74.2669731326559,138.2,150.54,89.46515397082672,-10.534846029173279,0.8347920038014536,0.15353326991079708,0.04744525547445266,40676681,1.0
1158,IBM,1532062800000,146.35,148.86,146.26,148.58,6415972,-2.890000000000015,2.890000000000015,0.0,57.38715172542746,138.2,150.54,66.04538087520262,-33.95461912479738,0.9034474644420527,0.30351610881704827,0.013574347253965113,34260709,-1.0
1159,IBM,1532322000000,145.7,146.7,145.015,146.35,3897892,-0.6500000000000057,0.6500000000000057,0.0,54.19075452208308,139.3678,150.54,56.67818334795294,-43.32181665204706,0.8950901875382442,0.4218309245612875,0.006841268744385287,30362817,-1.0
1160,IBM,1532408400000,146.38,147.04,145.92,146.7,3891625,0.6800000000000068,0.0,0.6800000000000068,57.0766658565907,139.93,150.54,60.79170593779452,-39.20829406220549,0.9325866208982916,0.5239820638286884,0.00993514557748032,34254442,1.0
1161,IBM,1532494800000,146.62,146.65,145.5,146.01,3623182,0.2400000000000091,0.0,0.2400000000000091,58.150338844561496,141.17,150.54,58.16435432230538,-41.835645677694615,0.970481559133475,0.6132819628896458,0.0011608057357461732,37877624,1.0
1162,IBM,1532581200000,146.71,149.27,146.63,147.43,4778022,0.09000000000000341,0.0,0.09000000000000341,58.598438360815784,142.47,150.54,52.54027261462222,-47.45972738537779,0.9962911364322622,0.6898837975981691,0.0055517477724469355,42655646,1.0
1163,IBM,1532667600000,145.15,147.14,144.66,146.89,3749642,-1.5600000000000023,1.5600000000000023,0.0,48.26304042839399,142.7351,150.54,30.940819228946125,-69.05918077105387,0.880714819450219,0.7280500019685792,-0.002131170081121958,38906004,-1.0
1164,IBM,1532926800000,145.49,146.24,144.69,144.8,3608283,0.3400000000000034,0.0,0.3400000000000034,50.46037457204931,142.7351,150.54,35.2970569770275,-64.7029430229725,0.807249300128376,0.7438898616005386,0.013938253536831757,42514287,1.0
1165,IBM,1533013200000,144.93,145.8,144.159,145.74,5474478,-0.5600000000000023,0.5600000000000023,0.0,46.69167376746187,142.7351,150.54,28.12207715665822,-71.87792284334178,0.6958192715013354,0.734275743580698,0.002836977580957578,37039809,-1.0
1166,IBM,1533099600000,143.5,145.19,143.34,144.76,3388386,-1.4300000000000068,1.4300000000000068,0.0,38.27004520597118,142.7351,150.54,9.800253686786649,-90.19974631321335,0.4865134170063925,0.684723278265837,-0.03846153846153855,33651423,-1.0
1167,IBM,1533186000000,142.96,143.36,142.33,142.86,3841447,-0.539999999999992,0.539999999999992,0.0,35.4815800569108,142.33,150.54,7.673568818513971,-92.32643118148603,0.27390629787896614,0.6025598821884629,-0.023163648787154045,29809976,-1.0
1168,IBM,1533272400000,147.7,147.92,143.0,143.24,8053567,4.739999999999981,0.0,4.739999999999981,62.87713928662796,142.33,150.54,65.40803897685737,-34.59196102314264,0.4823305343412301,0.5785140126190164,0.013726835964310125,37863543,1.0
1169,IBM,1533531600000,146.03,147.2,145.57,146.95,3913743,-1.6699999999999875,1.6699999999999875,0.0,53.621226988154476,142.33,150.54,45.066991473812394,-54.9330085261876,0.5069103241367827,0.5641932749225697,-0.0023910370269162318,33949800,-1.0
1170,IBM,1533618000000,147.01,147.64,146.35,146.65,3508758,0.9799999999999898,0.0,0.9799999999999898,57.824998251522906,142.33,150.54,57.003654080389644,-42.99634591961035,0.5985676138867859,0.571068142715413,0.0026599372527622567,37458558,1.0
1171,IBM,1533704400000,146.89,147.43,146.24,147.33,3581746,-0.12000000000000455,0.12000000000000455,0.0,57.093838724460134,142.33,149.27,65.70605187319849,-34.29394812680151,0.6539849709166958,0.5876515083556696,0.0012269102310680235,33876812,-1.0
1172,IBM,1533790800000,144.77,145.94,144.73,145.53,3093504,-2.119999999999976,2.119999999999976,0.0,45.39362270340041,142.33,149.27,35.158501440922166,-64.84149855907782,0.5208339736059315,0.574288001405722,-0.002617981398553182,30783308,-1.0
1173,IBM,1533877200000,144.48,145.07,143.88,144.5,3003158,-0.29000000000002046,0.29000000000002046,0.0,43.97134491035583,142.33,149.27,30.979827089336858,-69.02017291066315,0.3874441204418986,0.5369192252129573,-0.006942057873393526,27780150,-1.0
1174,IBM,1534136400000,142.71,144.3,142.53,144.15,2858842,-1.7699999999999818,1.7699999999999818,0.0,36.02276108758571,142.33,149.27,5.475504322766507,-94.52449567723349,0.13732484694071445,0.4570003495585087,-0.01531773959842686,24921308,-1.0
1175,IBM,1534222800000,143.36,143.82,142.93,143.0,2860041,0.6500000000000057,0.0,0.6500000000000057,40.57453414975417,142.33,149.27,14.84149855907783,-85.15850144092218,-0.008350762099297526,0.36393012722694745,-0.0009756097560974508,27781349,1.0
1176,IBM,1534309200000,143.91,144.0,142.0,142.55,4241496,0.549999999999983,0.0,0.549999999999983,44.434284860899716,142.0,147.92,32.26351351351352,-67.73648648648648,-0.07851435313168054,0.27544123115522184,0.006645215444879504,32022845,1.0
1177,IBM,1534395600000,145.34,145.68,144.37,144.37,5250878,1.4300000000000068,0.0,1.4300000000000068,53.4957873052618,142.0,147.92,56.41891891891909,-43.5810810810809,-0.018517221658214567,0.21664954059253455,-0.01597833446174668,37273723,1.0
1178,IBM,1534482000000,146.06,146.39,144.69,144.79,2678820,0.7199999999999989,0.0,0.7199999999999989,57.52034917127257,142.0,147.92,68.58108108108127,-31.418918918918738,0.0861358941071444,0.19054681129545653,0.00020543723892352261,39952543,1.0
1179,IBM,1534741200000,146.51,147.16,146.15,146.37,2499654,0.44999999999998863,0.0,0.44999999999998863,60.01576554819045,142.0,147.92,76.18243243243244,-23.81756756756756,0.20304484477699702,0.19304641799176464,-0.0034011291748861083,42452197,1.0
1180,IBM,1534827600000,145.97,147.12,145.89,147.0,3106876,-0.539999999999992,0.539999999999992,0.0,55.50141489328823,142.0,147.92,67.06081081081093,-32.939189189189065,0.24924941567780934,0.2042870175289736,-0.00626319014228327,39345321,-1.0
1181,IBM,1534914000000,145.24,146.16,145.19,146.01,2388961,-0.7299999999999898,0.7299999999999898,0.0,49.67327771856927,142.0,147.92,54.72972972973,-45.270270270270004,0.22437559197413748,0.2083047324180064,0.0032465289769980643,36956360,-1.0
1182,IBM,1535000400000,145.37,145.52,144.75,145.04,2220603,0.12999999999999545,0.0,0.12999999999999545,50.736249130582245,142.0,147.64,59.75177304964562,-40.24822695035438,0.21270092318457046,0.20918397057131924,0.006160022148394395,39176963,1.0
1183,IBM,1535086800000,146.04,146.0869,144.87,145.46,2776813,0.6699999999999875,0.0,0.6699999999999875,56.2334837660656,142.0,147.64,71.6312056737589,-28.368794326241105,0.25457738883781644,0.21826265422461869,0.023334034055076724,41953776,1.0
1184,IBM,1535346000000,146.69,147.62,146.52,146.94,3491565,0.6500000000000057,0.0,0.6500000000000057,61.09337767452502,142.0,147.62,83.45195729537356,-16.548042704626443,0.33633721116501647,0.24187756561269827,0.023228236607142794,45445341,1.0
1185,IBM,1535432400000,146.59,146.99,146.19,146.95,2455328,-0.09999999999999432,0.09999999999999432,0.0,59.91241496131337,142.0,147.62,81.67259786476868,-18.32740213523132,0.3885839481493747,0.2712188421200336,0.01862275033006755,42990013,-1.0
1186,IBM,1535518800000,147.54,147.93,146.6,146.87,3153845,0.9499999999999886,0.0,0.9499999999999886,66.92147389151148,142.0,147.93,93.42327150084293,-6.576728499157071,0.50087309560638,0.31714969281730293,0.015136920324755776,46143858,1.0
1187,IBM,1535605200000,145.93,147.3,145.25,147.03,3340369,-1.6099999999999852,1.6099999999999852,0.0,49.87066010583786,142.0,147.93,66.27318718381116,-33.72681281618883,0.45470803246101354,0.3446613607460451,-0.0008900451869094939,42803489,-1.0
1188,IBM,1535691600000,146.48,146.78,145.5401,145.72,3488476,0.549999999999983,0.0,0.549999999999983,54.44568876466347,142.0,147.93,75.54806070826281,-24.45193929173719,0.45723157275446624,0.36717540314772934,-0.00020476417991943663,46291965,1.0
1189,IBM,1536037200000,145.68,146.19,144.81,145.98,3326153,-0.799999999999983,0.799999999999983,0.0,47.213882947083164,142.0,147.93,62.05733558178756,-37.94266441821244,0.3901804736967449,0.3717764172575325,-0.0019867095978625127,42965812,-1.0
1190,IBM,1536123600000,146.66,146.75,145.05,145.19,3126540,0.9799999999999898,0.0,0.9799999999999898,55.557683971160415,144.37,147.93,64.32584269662895,-35.674157303371054,0.41137764284655987,0.37969666237533806,0.009776920958413537,46092352,1.0
1191,IBM,1536210000000,146.39,147.66,145.54,146.88,4248831,-0.27000000000001023,0.27000000000001023,0.0,52.8995212723236,144.69,147.93,52.469135802468635,-47.530864197531365,0.4017585992241379,0.3841090497450981,0.007016578386186856,41843521,-1.0
1192,IBM,1536296400000,145.45,146.5031,145.12,145.94,4693127,-0.9399999999999977,0.9399999999999977,0.0,44.371413395037045,144.75,147.93,22.012578616351796,-77.9874213836482,0.3146581561757955,0.37021887103123763,-0.004039989044097525,37150394,-1.0
1193,IBM,1536555600000,145.65,147.3,145.56,146.6,3618292,0.20000000000001705,0.0,0.20000000000001705,46.489248029809175,144.75,147.93,28.301886792452947,-71.69811320754705,0.25878562751793766,0.3479322223285777,-0.007089781171177312,40768686,1.0
1194,IBM,1536642000000,146.49,146.99,145.25,146.0,3374774,0.8400000000000034,0.0,0.8400000000000034,54.82410227298457,144.75,147.93,54.71698113207564,-45.283018867924355,0.2790702424776157,0.3341598263583853,-0.0006821747731768912,44143460,1.0
1195,IBM,1536728400000,146.57,147.98,146.03,146.37,4506679,0.07999999999998408,0.0,0.07999999999998408,55.58434389864448,144.75,147.98,56.34674922600615,-43.65325077399384,0.2981642223592189,0.32696070555855206,-0.006574488274366241,48650139,1.0
1196,IBM,1536814800000,148.95,149.0,147.1179,147.35,5346540,2.3799999999999955,0.0,2.3799999999999955,71.84730695283349,144.81,149.0,98.80668257756537,-1.1933174224346395,0.49958347490496635,0.36148525942783494,0.02069485369697799,53996679,1.0
1197,IBM,1536901200000,148.33,149.3,147.78,148.85,3452144,-0.6199999999999761,0.6199999999999761,0.0,64.7238533797238,144.81,149.3,78.39643652561254,-21.603563474387457,0.6022386524209651,0.40963593802646103,0.012629710540688288,50544535,-1.0
1198,IBM,1537160400000,147.94,149.07,147.77,148.44,3551882,-0.3900000000000148,0.3900000000000148,0.0,60.378890629685095,144.81,149.3,69.71046770601312,-30.28953229398688,0.6446922794983152,0.45664720632083194,0.015513454146073524,46992653,-1.0
1199,IBM,1537246800000,148.56,148.985,147.47,147.76,3629596,0.6200000000000045,0.0,0.6200000000000045,64.72288935006891,144.81,149.3,83.51893095768357,-16.481069042316427,0.7200654189820739,0.5093308488530803,0.01295513432428752,50622249,1.0
1200,IBM,1537333200000,149.06,149.9599,148.23,148.63,4246382,0.5,0.0,0.5,67.98871084539459,144.81,149.9599,82.5258742888211,-17.474125711178896,0.8107986008466241,0.5696243992517891,0.01823895074800208,54868631,1.0
1201,IBM,1537419600000,151.15,151.38,149.44,149.58,5952223,2.0900000000000034,0.0,2.0900000000000034,77.86986520382786,144.81,151.38,96.49923896499254,-3.500761035007458,1.0393695767128293,0.6635734347439972,0.039188724647645445,60820854,1.0
1202,IBM,1537506000000,151.35,152.6,150.74,151.48,19947878,0.19999999999998863,0.0,0.19999999999998863,78.59926368004986,144.81,152.6,83.95378690629009,-16.046213093709902,1.2225591438211438,0.7753705765594266,0.03913491246138001,80768732,1.0
1203,IBM,1537765200000,150.03,151.2,149.46,151.1,4264984,-1.3199999999999932,1.3199999999999932,0.0,62.82917917019043,145.05,152.6,65.96026490066227,-34.03973509933774,1.2468523166100738,0.8696669245695563,0.024165472045873493,76503748,-1.0
1204,IBM,1537851600000,148.91,150.41,148.36,149.91,4397457,-1.1200000000000045,1.1200000000000045,0.0,52.5138835620624,145.12,152.6,50.66844919786092,-49.33155080213908,1.1623315776174081,0.9281998551791268,0.015965067885651996,72106291,-1.0
1205,IBM,1537938000000,151.61,153.35,151.34,152.4,7401862,2.700000000000017,0.0,2.700000000000017,67.40117962873367,145.12,153.35,78.85783718104517,-21.142162818954834,1.298250248396414,1.0022099338225843,0.017858341725411453,79508153,1.0
1206,IBM,1538024400000,151.5,152.3888,151.16,152.01,3477643,-0.11000000000001364,0.11000000000001364,0.0,66.42227641205987,145.25,153.35,77.16049382716055,-22.839506172839453,1.381169433104077,1.0780018336788828,0.021371266770039643,76030510,-1.0
1207,IBM,1538110800000,151.21,151.625,150.79,151.16,3305798,-0.28999999999999204,0.28999999999999204,0.0,63.61190400662389,145.25,153.35,73.5802469135804,-26.4197530864196,1.4072608843587773,1.1438536438148617,0.02210355549547116,72724712,-1.0
1208,IBM,1538370000000,153.0,153.42,151.71,151.71,3757419,1.789999999999992,0.0,1.789999999999992,72.03792375068474,146.03,153.42,94.31664411366728,-5.683355886332723,1.5544577404058373,1.225974463133057,0.02988691437802915,76482131,1.0
1209,IBM,1538456400000,153.75,153.84,152.5,152.99,3030125,0.75,0.0,0.75,74.85308918495559,147.1179,153.84,98.66113268175118,-1.33886731824881,1.7118973436614056,1.3231590392387267,0.031463840064403614,79512256,1.0
1210,IBM,1538542800000,153.22,154.36,152.8,154.0,3315298,-0.5300000000000011,0.5300000000000011,0.0,69.17446862569523,147.47,154.36,83.45428156748893,-16.545718432511062,1.7734594619665245,1.4132191237842864,0.01369500496195819,76196958,-1.0
1211,IBM,1538629200000,151.31,152.8,150.36,151.69,4238143,-1.9099999999999966,1.9099999999999966,0.0,52.58593124585999,147.47,154.36,55.73294629898397,-44.26705370101603,1.6491168751716998,1.4603986740617692,-0.00026428807400058485,71958815,-1.0
1212,IBM,1538715600000,149.03,151.79,147.87,150.9,4602252,-2.280000000000001,2.280000000000001,0.0,39.529308234748186,147.47,154.36,22.64150943396225,-77.35849056603776,1.3510237964994758,1.4385236985493106,-0.006665333599946699,67356563,-1.0
1213,IBM,1538974800000,148.39,149.07,147.18,148.5,3239347,-0.6400000000000148,0.6400000000000148,0.0,36.58704413017084,147.18,154.36,16.85236768802198,-83.14763231197801,1.0510246807413637,1.3610238949877214,-0.003492042173124821,64117216,-1.0
1214,IBM,1539061200000,147.24,148.36,146.93,148.08,3642496,-1.1499999999999773,1.1499999999999773,0.0,31.695696670041954,146.93,154.36,4.172274562584145,-95.82772543741585,0.7122672679000459,1.2312725695701863,-0.028823956203416712,60474720,-1.0
1215,IBM,1539147600000,142.69,147.69,142.5,147.5,5547697,-4.550000000000011,4.550000000000011,0.0,19.682769231636243,142.5,154.36,1.6020236087689501,-98.39797639123104,0.07577910745294503,1.000173877146738,-0.05815181518151813,54927023,-1.0
1216,IBM,1539234000000,139.02,144.19,138.78,142.62,8710491,-3.6699999999999875,3.6699999999999875,0.0,14.55032866021547,138.78,154.36,1.5404364569962061,-98.4595635430038,-0.7165210363470749,0.6568348944479754,-0.08061636135176242,46216532,-1.0
1217,IBM,1539320400000,140.85,141.54,139.08,141.12,6563403,1.829999999999984,0.0,1.829999999999984,25.697710038981214,138.78,154.36,13.28626444159173,-86.71373555840827,-1.1831206365176286,0.2888437882548545,-0.0794117647058824,52779935,1.0
1218,IBM,1539579600000,141.13,142.26,140.14,140.38,4965533,0.28000000000000114,0.0,0.28000000000000114,27.370458405458976,138.78,154.36,15.083440308087242,-84.91655969191275,-1.5128710865027415,-0.0714991866966648,-0.08208130081300813,57745468,1.0
1219,IBM,1539666000000,145.12,145.45,141.58,142.93,8695489,3.990000000000009,0.0,3.990000000000009,46.99198285347704,138.78,154.36,40.69319640564826,-59.30680359435174,-1.4356913080072786,-0.3443376109587877,-0.052865161206108846,66440957,1.0
1220,IBM,1539752400000,134.05,137.15,133.4193,135.89,19463962,-11.069999999999993,11.069999999999993,0.0,25.19876578531715,133.4193,154.36,3.0118381907004927,-96.98816180929951,-2.2419385267096743,-0.7238577941089652,-0.11407045139118355,46976995,-1.0
1221,IBM,1539838800000,130.55,133.4,130.04,132.73,10011678,-3.5,3.5,0.0,21.552390592392143,130.04,154.36,2.0970394736842883,-97.90296052631571,-3.1272668012087763,-1.2045395955289278,-0.12400187881634561,36965317,-1.0
1222,IBM,1539925200000,129.1,131.89,127.96,130.65,7791636,-1.450000000000017,1.450000000000017,0.0,20.158021186476162,127.96,154.36,4.318181818181817,-95.68181818181817,-3.900931204373535,-1.7438179172978492,-0.1299952827009906,29173681,-1.0
1223,IBM,1540184400000,130.02,130.4379,128.4,129.58,5719518,0.9200000000000159,0.0,0.9200000000000159,23.76865710661933,127.96,154.36,7.8030303030303605,-92.19696969696965,-4.3892331622017196,-2.2729009662786233,-0.11695191524042381,34893199,1.0
1224,IBM,1540270800000,131.21,131.9,128.41,129.02,6463580,1.1899999999999977,0.0,1.1899999999999977,28.58844511142337,127.96,152.8,13.083735909822913,-86.91626409017708,-4.626857399360347,-2.7436922528949683,-0.0804541313336603,41356779,1.0
1225,IBM,1540357200000,127.21,131.69,127.0,131.17,5710320,-4.000000000000014,4.000000000000014,0.0,22.958555675868382,127.0,151.79,0.8471157724888819,-99.15288422751112,-5.079390818325834,-3.210831965981142,-0.08495180549561221,35646459,-1.0
1226,IBM,1540443600000,126.45,127.79,125.14,127.25,10304327,-0.7599999999999909,0.7599999999999909,0.0,22.008390474126998,125.14,149.07,5.4743000417885606,-94.52569995821143,-5.436681774954025,-3.656001927775719,-0.10223642172523961,25342132,-1.0
1227,IBM,1540530000000,124.79,125.78,123.71,125.21,8767029,-1.6599999999999966,1.6599999999999966,0.0,19.929665776337274,123.71,148.36,4.381338742393556,-95.61866125760645,-5.787075746066677,-4.082216691433911,-0.11577977751009705,16575103,-1.0
1228,IBM,1540789200000,119.64,123.95,118.3,119.34,20450448,-5.150000000000006,5.150000000000006,0.0,14.89391167525207,118.3,147.69,4.559373936713179,-95.44062606328681,-6.406477550576142,-4.547068863262357,-0.17557883131201768,-3875345,-1.0
1229,IBM,1540875600000,115.4,121.5,115.15,120.48,21458594,-4.239999999999995,4.239999999999995,0.0,12.010899015913836,115.15,145.45,0.8250825082508255,-99.17491749174917,-7.1569891791270095,-5.069052926435288,-0.13912719134651252,-25333939,-1.0
1230,IBM,1540962000000,115.43,116.5,114.09,116.49,21644978,0.030000000000001137,0.0,0.030000000000001137,12.149729291041865,114.09,145.45,4.272959183673483,-95.72704081632651,-7.661042572066748,-5.58745085556158,-0.11581769436997325,-3688961,1.0
1231,IBM,1541048400000,116.83,117.0,115.11,115.5,13626730,1.3999999999999915,0.0,1.3999999999999915,19.028957582960132,114.09,145.45,8.737244897959172,-91.26275510204083,-7.856969961669222,-6.04135467678311,-0.0950426026336173,9937769,1.0
1232,IBM,1541134800000,115.67,117.75,114.5384,117.51,10589509,-1.1599999999999966,1.1599999999999966,0.0,17.70359148385016,114.09,145.45,5.0382653061224465,-94.96173469387756,-8.013471816998603,-6.435778104826209,-0.11036763574834652,-651740,-1.0
1233,IBM,1541397600000,120.06,120.77,116.0,116.1,9144598,4.390000000000001,0.0,4.390000000000001,36.89609173966146,114.09,137.15,25.888985255854287,-74.1110147441457,-7.694566193028493,-6.6875357224666665,-0.08497827909458122,8492858,1.0
1234,IBM,1541484000000,123.12,123.81,120.31,120.7,9597392,3.0600000000000023,0.0,3.0600000000000023,46.8628464839719,114.09,133.4,46.763335059554635,-53.236664940445365,-7.112921436906831,-6.772612865354699,-0.032151560411917246,18090250,1.0
1235,IBM,1541570400000,124.84,125.06,122.33,123.79,12382666,1.7199999999999989,0.0,1.7199999999999989,51.800235612697485,114.09,131.9,60.359348680516554,-39.640651319483446,-6.438949947828078,-6.705880281849374,-0.012732305258995602,30472916,1.0
1236,IBM,1541656800000,123.38,124.404,122.63,122.66,10396439,-1.460000000000008,1.460000000000008,0.0,47.47931916410142,114.09,131.9,52.161706906232396,-47.8382930937676,-5.953998494361926,-6.555503924351885,-0.011298982290247728,20076477,-1.0
1237,IBM,1541743200000,123.54,124.57,121.96,123.61,6961902,0.1600000000000108,0.0,0.1600000000000108,48.02751114956907,114.09,131.9,53.06007860752388,-46.93992139247613,-5.493435407079616,-6.343090220897432,0.03259779338014046,27038379,1.0
1238,IBM,1542002400000,120.9,123.57,120.65,123.5,5379113,-2.6400000000000006,2.6400000000000006,0.0,40.0657757293992,114.09,131.69,38.69318181818184,-61.30681818181816,-5.2805904157112735,-6.130590259860201,0.04766031195840559,21659266,-1.0
1239,IBM,1542088800000,120.84,122.2505,119.9,121.19,4084385,-0.060000000000002274,0.060000000000002274,0.0,39.89235438108789,114.09,127.79,49.27007299270072,-50.72992700729928,-5.058440175368119,-5.916160242961785,0.046868231828814055,17574881,-1.0
1240,IBM,1542175200000,120.2,121.93,119.77,121.11,4762275,-0.6400000000000006,0.6400000000000006,0.0,37.874664448896226,114.09,125.78,52.26689478186485,-47.73310521813515,-4.877798930054723,-5.708487980380373,0.028845330822562687,12812606,-1.0
1241,IBM,1542261600000,121.44,121.44,119.51,119.66,5207973,1.2399999999999949,0.0,1.2399999999999949,44.185689976304346,114.09,125.06,67.0009115770282,-32.99908842297178,-4.581766059028382,-5.483143596109976,0.049883288666032755,18020579,1.0
1242,IBM,1542348000000,121.57,121.85,120.5405,120.89,4076315,0.12999999999999545,0.0,0.12999999999999545,44.86324098722813,114.09,125.06,68.18596171376473,-31.814038286235274,-4.287247244936864,-5.243964325875353,0.012577044810927696,22096894,1.0
1243,IBM,1542607200000,120.31,122.18,119.77,121.63,4131238,-1.259999999999991,1.259999999999991,0.0,39.50063798618478,114.09,125.06,56.70009115770283,-43.29990884229718,-4.108154187102684,-5.01680229812082,-0.022823261858349597,17965656,-1.0
1244,IBM,1542693600000,117.2,119.49,116.6955,118.49,6233777,-3.1099999999999994,3.1099999999999994,0.0,29.468719097617395,114.5384,125.06,25.29653284671538,-74.70346715328462,-4.169113706634221,-4.8472645798235,-0.061198333867350185,11731879,-1.0
1245,IBM,1542780000000,118.57,119.51,117.39,117.61,5335842,1.3699999999999903,0.0,1.3699999999999903,37.53255579899001,114.5384,125.06,38.31736618004861,-61.682633819951384,-4.060074998399415,-4.689826663538684,-0.03898524882476906,17067721,1.0
1246,IBM,1542952800000,117.19,118.3382,116.91,118.09,2334730,-1.3799999999999955,1.3799999999999955,0.0,33.13015259766391,116.0,125.06,13.134657836644564,-86.86534216335544,-4.038462619059501,-4.559553854642847,-0.05140035615994831,14732991,-1.0
1247,IBM,1543212000000,119.56,120.25,118.06,118.37,5011130,2.3700000000000045,0.0,2.3700000000000045,45.741621041256984,116.6955,125.06,34.24592025823426,-65.75407974176575,-3.786447649740012,-4.404932613662281,-0.011083540115798263,19744121,1.0
1248,IBM,1543298400000,120.03,120.04,118.37,118.38,4903771,0.46999999999999886,0.0,0.46999999999999886,47.98628145424518,116.6955,125.06,39.86490525434877,-60.13509474565123,-3.508356746415245,-4.225617440212874,-0.006703078450844058,24647892,1.0
1249,IBM,1543384800000,123.0,123.09,120.22,121.01,5104520,2.969999999999999,0.0,2.969999999999999,60.03988835612861,116.6955,124.57,80.06222617309044,-19.937773826909563,-3.013574909435249,-3.983208934057349,0.02329450915141429,29752412,1.0
1250,IBM,1543471200000,121.48,123.1208,121.4,122.44,5200113,-1.519999999999996,1.519999999999996,0.0,52.812653693136085,116.6955,124.57,60.75941329608242,-39.240586703917586,-2.712836148446627,-3.7291343769352054,0.00032938076416333395,24552299,-1.0
1251,IBM,1543557600000,124.27,124.69,121.48,121.66,7251590,2.789999999999992,0.0,2.789999999999992,62.39877281414688,116.6955,124.69,94.7463881418475,-5.2536118581524995,-2.2237349992644653,-3.4280545014010575,0.022209426667763488,31803889,1.0
1252,IBM,1543816800000,125.31,126.59,124.36,125.67,5843112,1.0400000000000063,0.0,1.0400000000000063,65.4202297786876,116.6955,126.59,87.0635201374501,-12.936479862549902,-1.7322314213577386,-3.0888898853923936,0.04155930512841821,37647001,1.0
1253,IBM,1543903200000,121.6,124.92,121.33,124.49,6000697,-3.710000000000008,3.710000000000008,0.0,49.160335742927906,116.6955,126.59,49.56794178584057,-50.43205821415944,-1.623364155874853,-2.795784739488886,0.03754266211604085,31646304,-1.0
1254,IBM,1544076000000,123.91,123.91,119.301,119.72,6938049,2.3100000000000023,0.0,2.3100000000000023,56.86300892384026,116.6955,126.59,72.91424528778609,-27.085754712213905,-1.335295910002003,-2.5036869735915097,0.04503668718900222,38584353,1.0
1255,IBM,1544162400000,119.34,124.05,118.87,123.9,7019616,-4.569999999999993,4.569999999999993,0.0,42.2505503008081,116.6955,126.59,26.726969528526006,-73.27303047147399,-1.4589427707856686,-2.2947381330303416,0.018346275279460755,31564737,-1.0
1256,IBM,1544421600000,121.13,121.6822,118.52,119.74,6549506,1.789999999999992,0.0,1.789999999999992,48.25962703964509,116.6955,126.59,44.81782808631054,-55.18217191368946,-1.3963989412918636,-2.115070294682646,0.013131482101037095,38114243,1.0
1257,IBM,1544508000000,120.89,123.81,120.0,123.25,5043081,-0.23999999999999488,0.23999999999999488,0.0,47.495061929303105,116.6955,126.59,42.39223811208249,-57.607761887917505,-1.3506292862882532,-1.9621820930037674,0.007164875447804642,33071162,-1.0
1258,IBM,1544594400000,121.16,122.88,121.0,122.51,3560790,0.269999999999996,0.0,0.269999999999996,48.553073407095496,116.91,126.59,43.90495867768592,-56.095041322314074,-1.2778396217719603,-1.825313598757406,-0.014959349593495985,36631952,1.0
1259,IBM,1544680800000,120.73,121.79,120.17,121.26,3993597,-0.4299999999999926,0.4299999999999926,0.0,46.819394676265134,116.91,126.59,39.462809917355415,-60.53719008264458,-1.2405504016200695,-1.708360959329939,-0.006173855778728976,32638355,-1.0
1260,IBM,1544767200000,119.9,121.11,119.44,119.5,4554204,-0.8299999999999983,0.8299999999999983,0.0,43.37032391446705,118.06,126.59,21.570926143024657,-78.42907385697534,-1.2634087001217154,-1.619370507488294,-0.03516536573589757,28084151,-1.0
1261,IBM,1545026400000,116.1,119.78,115.07,119.07,7374476,-3.8000000000000114,3.8000000000000114,0.0,31.220508230357837,115.07,126.59,8.940972222222223,-91.05902777777779,-1.570053705719289,-1.6095071471344933,-0.07349772564041179,20709675,-1.0
1262,IBM,1545112800000,116.65,118.23,116.02,116.9,6290186,0.5500000000000114,0.0,0.5500000000000114,34.29452060762242,115.07,126.59,13.715277777777873,-86.28472222222211,-1.7485356480367784,-1.6373128473149505,-0.0407072368421052,26999861,1.0
1263,IBM,1545199200000,116.43,120.27,115.97,117.15,6979823,-0.21999999999999886,0.21999999999999886,0.0,33.60139513870844,115.07,126.59,11.805555555555664,-88.19444444444434,-1.8859954529504108,-1.687049368442043,-0.0603663949640868,20020038,-1.0
1264,IBM,1545285600000,113.02,116.45,111.7,115.7,8454350,-3.410000000000011,3.410000000000011,0.0,24.680315248142477,111.7,126.59,8.865010073875037,-91.13498992612496,-2.2442218469885518,-1.7984838641513448,-0.05295793531087656,11565688,-1.0
1265,IBM,1545372000000,110.94,115.28,110.44,112.5,10386453,-2.0799999999999983,2.0799999999999983,0.0,20.794625776055625,110.44,126.59,3.0959752321981413,-96.90402476780186,-2.665234299517664,-1.971833951224609,-0.08412449434491864,1179235,-1.0
1266,IBM,1545631200000,107.57,111.0,107.5,109.9,3821376,-3.3700000000000045,3.3700000000000045,0.0,16.065960648376546,107.5,124.92,0.4018369690011089,-99.59816303099889,-3.2335462284283665,-2.224176406665361,-0.11018281081975356,-2642141,-1.0
1267,IBM,1545804000000,111.39,111.39,105.94,108.0,6645794,3.8200000000000074,0.0,3.8200000000000074,35.30691744387504,105.94,124.05,30.09387078961901,-69.90612921038098,-3.3372259883473845,-2.4467863230017657,-0.0806371739848134,4003653,1.0
1268,IBM,1545890400000,113.78,113.78,109.4699,109.99,6045590,2.3900000000000006,0.0,2.3900000000000006,44.492789416960264,105.94,124.05,43.290999447818905,-56.7090005521811,-3.189770233752782,-2.595383105151969,-0.05756647063695852,10049243,1.0
1269,IBM,1545976800000,113.03,114.8,112.5,114.22,5117533,-0.75,0.75,0.0,42.31713425531547,105.94,123.81,39.675433687744835,-60.324566312255165,-3.0977206226839087,-2.695850608658357,-0.05729774812343624,4931710,-1.0
1270,IBM,1546236000000,113.67,114.35,112.4201,113.33,4982755,0.6400000000000006,0.0,0.6400000000000006,44.966804189937136,105.94,123.81,43.25685506435368,-56.74314493564633,-2.939246191030776,-2.7445297251328413,-0.020930232558139528,9914465,1.0
1271,IBM,1546408800000,115.21,115.98,111.69,112.01,4239924,1.539999999999992,0.0,1.539999999999992,51.191638952527136,105.94,122.88,54.72255017709562,-45.27744982290439,-2.65874062575854,-2.7273719052579812,-0.012344620660094452,14154389,1.0
1272,IBM,1546495200000,112.91,114.88,112.69,114.53,4346659,-2.299999999999997,2.299999999999997,0.0,42.84103203900225,105.94,121.79,43.974763406940035,-56.025236593059965,-2.5921480530038394,-2.700327134807153,-0.030232757880271466,9807730,-1.0
1273,IBM,1546581600000,117.32,117.49,114.44,114.91,4477755,4.409999999999997,0.0,4.409999999999997,57.99890543041092,105.94,121.11,75.01647989452863,-24.983520105471364,-2.15863936475931,-2.5919895807975846,0.03804636347549106,14285485,1.0
1274,IBM,1546840800000,118.15,118.83,116.67,117.5,3751204,0.8300000000000125,0.0,0.8300000000000125,60.286004057744385,105.94,120.27,85.20586182833225,-14.794138171667765,-1.7281851006555655,-2.419228684769181,0.06499008473048495,18036689,1.0
1275,IBM,1546927200000,119.83,120.57,118.98,119.66,4763636,1.6799999999999926,0.0,1.6799999999999926,64.76680277874149,105.94,120.57,94.94190020505813,-5.058099794941867,-1.23722309785623,-2.1828275673865907,0.11397229710885948,22800325,1.0
1276,IBM,1547013600000,120.69,121.4,119.87,120.91,3633663,0.8599999999999994,0.0,0.8599999999999994,66.96811803193835,105.94,121.4,95.4075032341526,-4.592496765847398,-0.7698628609972502,-1.9002346261087226,0.08349043899811481,26433988,1.0
1277,IBM,1547100000000,121.79,121.86,119.95,120.08,3909971,1.1000000000000085,0.0,1.1000000000000085,69.75680635943715,105.94,121.86,99.56030150753773,-0.4396984924622687,-0.30717477965211515,-1.5816226568174012,0.07039901564422579,30343959,1.0
1278,IBM,1547186400000,121.46,121.615,120.2,121.58,3722370,-0.3300000000000125,0.3300000000000125,0.0,67.77613411486624,105.94,121.86,97.48743718592962,-2.512562814070387,0.03250590836738354,-1.2587969437804443,0.0745819693886578,26621589,-1.0
1279,IBM,1547445600000,120.39,120.6548,119.7607,120.51,5228909,-1.0699999999999932,1.0699999999999932,0.0,61.267715777258815,105.94,121.86,90.76633165829146,-9.233668341708533,0.21291093854830478,-0.9644553673146944,0.0591185009237265,21392680,-1.0
1280,IBM,1547532000000,121.73,121.93,120.82,120.96,3507719,1.3400000000000034,0.0,1.3400000000000034,65.987347351625,105.94,121.93,98.74921826141336,-1.2507817385866336,0.45872216224879026,-0.6798198614019975,0.05659230969533913,24900399,1.0
1281,IBM,1547618400000,121.62,122.0,120.83,121.58,3841100,-0.10999999999999943,0.10999999999999943,0.0,65.23442940461877,109.4699,122.0,96.96730273501413,-3.0326972649858766,0.6373067715646386,-0.4163945348086702,0.07714108582056523,21059299,-1.0
1282,IBM,1547704800000,122.19,122.4085,120.55,120.56,5029871,0.5699999999999932,0.0,0.5699999999999932,67.45469726328025,111.69,122.4085,97.9614684890609,-2.0385315109390847,0.8154308184746952,-0.1700294641519971,0.041510398908966906,26089170,1.0
1283,IBM,1547791200000,123.82,124.7175,122.71,123.27,6008509,1.6299999999999955,0.0,1.6299999999999955,73.11916837547057,111.69,124.7175,93.11072730761843,-6.889272692381559,1.0757225267381756,0.07912093402603751,0.04798984341938195,32097679,1.0
1284,IBM,1548136800000,122.52,123.8,121.54,123.3,10052384,-1.2999999999999972,1.2999999999999972,0.0,63.02465911831457,111.69,124.7175,83.13183649971211,-16.86816350028789,1.1636921269755192,0.29603517261593393,0.02244846866394057,22045295,-1.0
1285,IBM,1548223200000,132.89,135.0,130.31,131.37,22063666,10.36999999999999,0.0,10.36999999999999,83.71620428970618,112.69,135.0,90.54235768713575,-9.457642312864246,2.0465891965457814,0.6461459774019036,0.10108542547021293,44108961,1.0
1286,IBM,1548309600000,132.53,133.2054,131.43,132.63,6322928,-0.3599999999999852,0.3599999999999852,0.0,81.88078874498545,114.44,135.0,87.98638132295721,-12.013618677042794,2.686276767338029,1.054172135389129,0.08818458001477958,37786033,-1.0
1287,IBM,1548396000000,133.97,134.44,132.43,132.87,5708500,1.4399999999999977,0.0,1.4399999999999977,83.54577344584344,116.67,135.0,94.38079650845607,-5.619203491543924,3.271715442211189,1.497680796753541,0.10299687139799119,43494533,1.0
1288,IBM,1548655200000,134.27,134.805,132.58,133.1,5357736,0.30000000000001137,0.0,0.30000000000001137,83.90137721247632,118.98,135.0,95.44319600499382,-4.55680399500618,3.7170395841385755,1.941552554230548,0.11529196777140971,48852269,1.0
1289,IBM,1548741600000,134.33,135.4149,133.6,134.29,5037129,0.060000000000002274,0.0,0.060000000000002274,83.98126767335285,119.7607,135.4149,93.06959154731652,-6.930408452683477,4.028367164456228,2.3589154762756843,0.1035077630822312,53889398,1.0
1290,IBM,1548828000000,134.38,135.03,133.25,134.0,4500919,0.04999999999998295,0.0,0.04999999999998295,84.05734121124301,119.7607,135.4149,93.3889946468041,-6.6110053531959085,4.2303660702336146,2.7332055950672705,0.10491695444828153,58390317,1.0
1291,IBM,1548914400000,134.42,134.716,133.74,134.45,4884031,0.03999999999999204,0.0,0.03999999999999204,84.1269244193174,119.7607,135.4149,93.64451712639418,-6.355482873605818,4.3436089044400745,3.0552862569418315,0.1000900237335296,63274348,1.0
1292,IBM,1549000800000,134.1,135.2,133.35,134.97,3806047,-0.3199999999999932,0.3199999999999932,0.0,80.86883660569869,119.7607,135.4149,91.60033728967308,-8.399662710326911,4.357305040595676,3.3156900136726004,0.08302374414472613,59468301,-1.0
1293,IBM,1549260000000,135.19,135.2,132.99,134.02,3966597,1.0900000000000034,0.0,1.0900000000000034,83.39615960695454,120.55,135.4149,98.48703993972384,-1.5129600602761615,4.405331300629399,3.5336182710639603,0.10341168788769184,63434898,1.0
1294,IBM,1549346400000,135.55,135.82,134.92,135.28,5398907,0.36000000000001364,0.0,0.36000000000001364,84.19198992943997,120.55,135.82,98.2318271119844,-1.7681728880155982,4.421473455340617,3.7111893079192924,0.020016555045526463,68833805,1.0
1295,IBM,1549432800000,136.32,136.65,135.17,135.22,4879670,0.7699999999999818,0.0,0.7699999999999818,85.86412294845418,120.55,136.65,97.95031055900614,-2.0496894409938653,4.445157782174931,3.8579830027704203,0.028597298724816866,73713475,1.0
1296,IBM,1549519200000,133.19,134.47,132.12,133.55,4379439,-3.1299999999999955,3.1299999999999955,0.0,57.39083230937766,121.54,136.65,77.10125744540034,-22.898742554599657,4.163370200317246,3.919060442279786,-0.005822198999776096,69334036,-1.0
1297,IBM,1549605600000,133.71,133.71,132.19,132.34,3250074,0.5200000000000102,0.0,0.5200000000000102,59.937492304214786,121.54,136.65,80.54268696227666,-19.45731303772335,3.936632121071682,3.9225747780381655,-0.004170700826692464,72584110,1.0
1298,IBM,1549864800000,133.99,135.15,133.91,134.29,3095069,0.28000000000000114,0.0,0.28000000000000114,61.37190398073845,130.31,136.65,58.04416403785496,-41.95583596214503,3.736462604608761,3.8853523433522854,-0.0025310801756868173,75679179,1.0
1299,IBM,1549951200000,136.05,136.2,134.86,135.15,3317161,2.0600000000000023,0.0,2.0600000000000023,70.37594210405746,131.43,136.65,88.50574712643689,-11.494252873563111,3.7013843497502705,3.848558744631883,0.012427444560202616,78996340,1.0
1300,IBM,1550037600000,137.52,137.92,136.41,136.92,4253042,1.4699999999999989,0.0,1.4699999999999989,75.14604319720539,132.12,137.92,93.10344827586245,-6.896551724137559,3.748985325557726,3.828644060817052,0.02306204433864023,83249382,1.0
1301,IBM,1550124000000,136.48,137.6019,136.21,137.17,2789839,-1.0400000000000205,1.0400000000000205,0.0,66.41594190282584,132.12,137.92,75.17241379310342,-24.827586206896584,3.6605930949266394,3.7950338676389697,0.017747949291573528,80459543,-1.0
1302,IBM,1550210400000,138.03,138.185,137.385,137.58,3844062,1.5500000000000114,0.0,1.5500000000000114,72.00823273488422,132.12,138.185,97.44435284418795,-2.555647155812056,3.673270485783945,3.770681191267965,0.021007470966787567,84303605,1.0
1303,IBM,1550556000000,138.7,138.7,137.36,137.81,3385675,0.6699999999999875,0.0,0.6699999999999875,74.15472234240329,132.12,138.7,100.0,-0.0,3.694789575641778,3.755502868142728,0.023238657322021128,87689280,1.0
1304,IBM,1550642400000,138.0,139.24,137.2203,138.76,3801979,-0.6999999999999886,0.6999999999999886,0.0,67.87977600499377,132.12,139.24,82.58426966292123,-17.41573033707877,3.6137029414828703,3.7271428828107567,0.012323943661971981,83887301,-1.0
1305,IBM,1550728800000,137.84,138.35,137.35,137.82,2937467,-0.1599999999999966,0.1599999999999966,0.0,66.3979549685502,132.12,139.24,80.33707865168532,-19.662921348314676,3.49622819459006,3.680959945166617,0.03491253097079361,80949834,-1.0
1306,IBM,1550815200000,139.25,139.38,138.43,138.73,3113698,1.4099999999999966,0.0,1.4099999999999966,72.50183633970909,132.12,139.38,98.20936639118464,-1.7906336088153667,3.4768251513484927,3.6401329864029925,0.041432951910851834,84063532,1.0
1307,IBM,1551074400000,139.46,140.47,139.32,140.0,3194161,0.21000000000000796,0.0,0.21000000000000796,73.33425570324196,132.12,140.47,87.90419161676657,-12.095808383233432,3.4387535345464357,3.599857096031681,0.040823942085230325,87257693,1.0
1308,IBM,1551160800000,139.72,140.49,139.47,139.67,3060381,0.2599999999999909,0.0,0.2599999999999909,74.43962564787383,132.12,140.49,90.80047789725198,-9.199522102748027,3.390478011015091,3.557981279028363,0.026975376699742704,90318074,1.0
1309,IBM,1551247200000,139.17,139.57,138.4007,139.25,2530968,-0.5500000000000114,0.5500000000000114,0.0,67.59992057378537,132.12,140.49,84.22939068100334,-15.770609318996664,3.270142737470394,3.500413570716769,0.011998254799301833,87787106,-1.0
1310,IBM,1551333600000,138.13,139.055,137.72,138.77,3457788,-1.039999999999992,1.039999999999992,0.0,56.31116079333209,132.19,140.49,71.56626506024084,-28.433734939759166,3.055633417889851,3.411457540151386,0.012089683470105639,84329318,-1.0
1311,IBM,1551420000000,139.2,140.04,138.64,139.31,3030044,1.0699999999999932,0.0,1.0699999999999932,63.539256737309664,133.91,140.49,80.39513677811523,-19.60486322188477,2.9381046527667536,3.3167869626744593,0.00847641816996303,87359362,1.0
1312,IBM,1551679200000,138.43,140.08,137.17,139.99,3407217,-0.7699999999999818,0.7699999999999818,0.0,55.86481766342026,134.86,140.49,63.41030195381876,-36.58969804618124,2.751116535904231,3.2036528773204136,-0.0019466474405189782,83952145,-1.0
1313,IBM,1551765600000,137.88,138.74,137.555,138.37,4250650,-0.5500000000000114,0.5500000000000114,0.0,50.807161345206026,136.21,140.49,39.01869158878474,-60.98130841121525,2.529389475277412,3.0688001969118135,-0.0008695652173913437,79701495,-1.0
1314,IBM,1551852000000,136.98,138.3892,136.72,138.12,2768256,-0.9000000000000057,0.9000000000000057,0.0,43.39013740211517,136.21,140.49,17.990654205607047,-82.00934579439296,2.255051869658473,2.906050531461146,-0.006239117817759765,76933239,-1.0
1315,IBM,1551938400000,135.36,136.89,134.6343,136.61,4358802,-1.6199999999999761,1.6199999999999761,0.0,33.29514364553248,134.6343,140.49,12.393052922793448,-87.60694707720656,1.885185633129339,2.7018775517947846,-0.027935368043087827,72574437,-1.0
1316,IBM,1552024800000,135.09,135.24,133.58,134.21,3773722,-0.27000000000001023,0.27000000000001023,0.0,31.869261328794238,133.58,140.49,21.852387843704655,-78.14761215629534,1.5523823351871897,2.4719785084732657,-0.03133514986376029,68800715,-1.0
1317,IBM,1552280400000,137.71,137.73,135.84,136.03,3939517,2.6200000000000045,0.0,2.6200000000000045,53.95014642183066,133.58,140.49,59.76845151953687,-40.23154848046313,1.4829508928003179,2.274172985338676,-0.014385914686515844,72740232,1.0
1318,IBM,1552366800000,138.28,139.695,137.86,138.52,3954653,0.5699999999999932,0.0,0.5699999999999932,57.41475370949011,133.58,140.49,68.0173661360346,-31.982633863965397,1.457123399272632,2.1107630681254674,-0.006395056405834487,76694885,1.0
1319,IBM,1552453200000,138.56,139.325,137.85,138.05,3173179,0.28000000000000114,0.0,0.28000000000000114,59.15648038328715,133.58,140.49,72.06946454413881,-27.930535455861182,1.4426189710176232,1.9771342487038985,0.003113009483819651,79868064,1.0
1320,IBM,1552539600000,138.79,138.94,138.06,138.51,2738790,0.22999999999998977,0.0,0.22999999999998977,60.6806891269117,133.58,140.49,75.39797395079569,-24.602026049204312,1.4331625788397275,1.8683399147310644,-0.0029454022988505413,82606854,1.0
1321,IBM,1552626000000,139.43,140.33,139.23,139.37,7153687,0.6400000000000148,0.0,0.6400000000000148,64.88776036190146,133.58,140.49,84.6599131693198,-15.340086830680214,1.4604755185410454,1.786767035493061,0.007223867658744387,89760541,1.0
1322,IBM,1552885200000,140.21,140.365,138.72,139.83,3268510,0.7800000000000011,0.0,0.7800000000000011,69.47996773845216,133.58,140.365,97.71554900515842,-2.2844509948415803,1.5274531719401239,1.7349042627824736,0.01689875253843942,93029051,1.0
1323,IBM,1552971600000,140.49,141.7024,140.002,140.96,3482336,0.28000000000000114,0.0,0.28000000000000114,71.0483352471,133.58,141.7024,85.07337732689842,-14.926622673101578,1.58485784999354,1.7048949802246869,0.02562417871222089,96511387,1.0
1324,IBM,1553058000000,139.6,140.7,138.98,140.53,3649455,-0.8900000000000148,0.8900000000000148,0.0,59.781334221892045,133.58,141.7024,74.11602482024996,-25.883975179750042,1.5407748159914831,1.6720709473780462,0.03132387706855777,92861932,-1.0
1325,IBM,1553144400000,141.44,142.12,138.88,139.1,3605420,1.8400000000000034,0.0,1.8400000000000034,70.8199788654834,133.58,142.12,92.03747072599523,-7.962529274004772,1.6354587658043727,1.6647485110633116,0.047005699903767795,96467352,1.0
1326,IBM,1553230800000,139.45,141.44,138.9,140.97,3877516,-1.990000000000009,1.990000000000009,0.0,52.75198110661841,133.58,142.12,68.73536299765787,-31.264637002342138,1.5322572020904772,1.638250249268745,0.012635247984895681,92589836,-1.0
1327,IBM,1553490000000,139.18,139.91,138.35,139.06,2839766,-0.2699999999999818,0.2699999999999818,0.0,50.725963861582024,133.58,142.12,65.57377049180327,-34.42622950819673,1.412401194029087,1.5930804382208137,0.006508533410471529,89750070,-1.0
1328,IBM,1553576400000,140.22,141.02,139.42,139.93,2553708,1.039999999999992,0.0,1.039999999999992,57.91045588713855,133.58,142.12,77.75175644028094,-22.248243559719057,1.385364137067512,1.5515371779901534,0.01198036951501158,92303778,1.0
1329,IBM,1553662800000,139.24,140.49,138.4,140.41,3098233,-0.9799999999999898,0.9799999999999898,0.0,49.98603929265363,133.58,142.12,66.27634660421548,-33.72365339578452,1.2702169940125998,1.495273141194643,0.003242308523669024,89205545,-1.0
1330,IBM,1553749200000,139.92,140.44,139.1,139.91,2663884,0.6799999999999784,0.0,0.6799999999999784,54.92439760752221,135.84,142.12,64.96815286624177,-35.03184713375823,1.2197716027976355,1.4401728335152417,0.003514308255038179,91869429,1.0
1331,IBM,1553835600000,141.1,141.22,140.15,140.5,3101454,1.1800000000000068,0.0,1.1800000000000068,62.36494526629367,137.85,142.12,76.11241217798576,-23.887587822014233,1.2604793834365182,1.4042341434994972,0.006347621425005334,94970883,1.0
1332,IBM,1554094800000,143.3,143.41,141.51,141.51,3984250,2.200000000000017,0.0,2.200000000000017,72.2271228233914,137.85,143.41,98.02158273381322,-1.9784172661867838,1.45350708184435,1.4140887311684678,0.020001423588867473,98955133,1.0
1333,IBM,1554181200000,143.0,143.95,142.6,143.35,2404920,-0.30000000000001137,0.30000000000001137,0.0,69.36703178409735,138.06,143.95,83.87096774193564,-16.12903225806436,1.5642438018866471,1.4441197453121037,0.024355300859598916,96550213,-1.0
1334,IBM,1554267600000,143.63,144.22,143.01,143.65,2681645,0.6299999999999955,0.0,0.6299999999999955,72.0489462856954,138.35,144.22,89.94889267461664,-10.051107325383356,1.6834336104447232,1.4919825183386277,0.015483597285067763,99231858,1.0
1335,IBM,1554354000000,142.78,144.14,142.54,143.62,2771462,-0.8499999999999943,0.8499999999999943,0.0,63.40686385300429,138.35,144.22,75.46848381601369,-24.531516183986312,1.6898252426723843,1.5315510632053793,0.023879526712083265,96460396,-1.0
1336,IBM,1554440400000,143.28,143.5,142.46,143.29,2731985,0.5,0.0,0.5,66.16171478053617,138.35,144.22,83.98637137989783,-16.013628620102164,1.7154617039025197,1.5683331913448075,0.02945825549647929,99192381,1.0
1337,IBM,1554699600000,143.39,143.42,142.87,143.02,2118228,0.10999999999998522,0.0,0.10999999999998522,66.79625066236109,138.35,144.22,85.8603066439521,-14.139693356047903,1.7247727580980836,1.599621104695463,0.022607331336471193,101310609,1.0
1338,IBM,1554786000000,142.11,142.95,141.84,142.66,3038460,-1.2799999999999727,1.2799999999999727,0.0,53.361217070174405,138.35,144.22,64.05451448040914,-35.94548551959086,1.6103039514646582,1.6017576740493022,0.02061189313415679,98272149,-1.0
1339,IBM,1554872400000,143.02,143.495,141.98,142.2,2678310,0.9099999999999966,0.0,0.9099999999999966,59.966475667171345,138.35,144.22,79.55706984667823,-20.442930153321768,1.5748619639140884,1.5963785320222597,0.022155517438536387,100950459,1.0
1340,IBM,1554958800000,143.78,144.11,143.03,143.8,2941985,0.7599999999999909,0.0,0.7599999999999909,64.7740444427401,138.35,144.22,92.50425894378199,-7.495741056218014,1.5897736606883939,1.5950575577554866,0.018993621545003503,103892444,1.0
1341,IBM,1555045200000,144.35,144.44,143.7,144.26,2898899,0.5699999999999932,0.0,0.5699999999999932,68.09020026853787,138.4,144.44,98.50993377483438,-1.4900662251656214,1.628809620717135,1.6018079703478163,0.007327285415212659,106791343,1.0
1342,IBM,1555304400000,143.9,144.4597,143.27,144.4,3603158,-0.44999999999998863,0.44999999999998863,0.0,62.7123262689634,138.4,144.4597,90.76356915358858,-9.236430846411423,1.6049339811874574,1.6024331725157448,0.0062937062937062915,103188185,-1.0
1343,IBM,1555390800000,145.14,145.39,144.02,144.4,6301671,1.2399999999999807,0.0,1.2399999999999807,70.19658950259218,139.1,145.39,96.02543720190778,-3.9745627980922147,1.6668555287783136,1.6153176437682588,0.010513123999164486,109489856,1.0
1344,IBM,1555477200000,139.11,141.98,136.26,137.37,12525693,-6.029999999999973,6.029999999999973,0.0,33.0145712625354,136.26,145.39,31.215772179627866,-68.78422782037214,1.215348416166421,1.5353237982478913,-0.025703880095251375,96964163,-1.0
1345,IBM,1555563600000,140.33,140.49,138.7,139.0,4960015,1.2199999999999989,0.0,1.2199999999999989,40.38605988211684,136.26,145.39,44.57831325301231,-55.421686746987696,0.945075340288696,1.4172741066560524,-0.0205890563930764,101924178,1.0
1346,IBM,1555909200000,138.89,140.56,138.48,139.42,4494333,-1.4400000000000261,1.4400000000000261,0.0,35.12217030212915,136.26,145.39,28.806133625410695,-71.1938663745893,0.6076810461936759,1.2553554945635772,-0.03138294162772859,97429845,-1.0
1347,IBM,1555995600000,140.44,140.92,138.9399,139.15,4462240,1.5500000000000114,0.0,1.5500000000000114,44.16131933511761,136.26,145.39,45.78313253012058,-54.21686746987942,0.46006237080598567,1.096296869812059,-0.01175146013651407,101892085,1.0
1348,IBM,1556082000000,139.95,141.31,139.78,140.6,2774867,-0.4900000000000091,0.4900000000000091,0.0,42.02553791968368,136.26,145.39,40.41621029572836,-59.58378970427164,0.30007551834219726,0.9370525995180866,-0.02146552929660206,99117218,-1.0
1349,IBM,1556168400000,138.63,139.7482,137.71,139.7,2910113,-1.3199999999999932,1.3199999999999932,0.0,36.53351896321191,136.26,145.39,25.958378970427226,-74.04162102957278,0.06601088443682102,0.7628442565018335,-0.03581861176797885,96207105,-1.0
1350,IBM,1556254800000,139.44,139.89,138.81,139.34,2319834,0.8100000000000023,0.0,0.8100000000000023,41.9086517463374,136.26,145.39,34.830230010952995,-65.16976998904701,-0.05350996417229226,0.5995734123670085,-0.03401454797367509,98526939,1.0
1351,IBM,1556514000000,139.05,139.63,138.81,139.15,2958333,-0.38999999999998636,0.38999999999998636,0.0,40.025401760199045,136.26,145.39,30.558598028477785,-69.44140197152221,-0.17765296562748745,0.44412813676810925,-0.03370396108408613,95568606,-1.0
1352,IBM,1556600400000,140.27,140.44,138.68,139.11,4638828,1.2199999999999989,0.0,1.2199999999999989,48.39557351662328,136.26,145.39,43.92113910186223,-56.07886089813777,-0.1755695284131491,0.32018860373185754,-0.033553810114372196,100207434,1.0
1353,IBM,1556686800000,140.56,141.81,140.17,140.55,3053683,0.28999999999999204,0.0,0.28999999999999204,50.29808049352296,136.26,145.39,47.09748083242074,-52.902519167579264,-0.1488025103288635,0.2263903809197133,0.010423405937747043,103261117,1.0
1354,IBM,1556773200000,139.59,141.28,139.41,140.5,3541352,-0.9699999999999989,0.9699999999999989,0.0,44.032841308245466,136.26,145.39,36.47316538882819,-63.5268346111718,-0.2035143621392308,0.14040943230792446,-0.005273284401054679,99719765,-1.0
1355,IBM,1556859600000,140.25,141.0,139.63,139.7,2580034,0.6599999999999966,0.0,0.6599999999999966,49.01846253236446,136.26,145.39,43.702081051478764,-56.29791894852124,-0.19141094846216333,0.07404535615390688,0.009791921664626724,102299799,1.0
1356,IBM,1557118800000,140.38,140.69,137.9,138.3,2793655,0.12999999999999545,0.0,0.12999999999999545,50.030138629713605,136.26,145.39,45.1259583789705,-54.8740416210295,-0.1693765252284436,0.02536097987743677,-0.0004272287097693006,105093454,1.0
1357,IBM,1557205200000,137.64,139.51,136.19,139.15,4726771,-2.740000000000009,2.740000000000009,0.0,33.744958256328076,136.19,141.98,25.04317789291866,-74.95682210708134,-0.3687583699853576,-0.053462890095122124,-0.016505894962486667,100366683,-1.0
1358,IBM,1557291600000,138.0,138.7,137.13,137.77,3818909,0.36000000000001364,0.0,0.36000000000001364,36.86069330956525,136.19,141.81,32.20640569395019,-67.79359430604981,-0.4920488937124503,-0.14118009081858782,-0.004544470893745878,104185592,1.0
1359,IBM,1557378000000,135.34,135.5848,133.03,134.89,4192942,-2.6599999999999966,2.6599999999999966,0.0,26.311586902737915,133.03,141.81,26.309794988610502,-73.6902050113895,-0.7952303707779151,-0.2719901468104533,-0.02940332759609865,99992650,-1.0
1360,IBM,1557464400000,135.32,135.75,132.42,134.88,3977686,-0.020000000000010232,0.020000000000010232,0.0,26.246421282280252,132.42,141.81,30.883919062832817,-69.1160809371672,-1.025298703284733,-0.4226518581053093,-0.02682488313556286,96014964,-1.0
1361,IBM,1557723600000,131.42,133.57,130.96,133.28,4958021,-3.9000000000000057,3.9000000000000057,0.0,16.854285576703703,130.96,141.81,4.239631336405344,-95.76036866359465,-1.504978465752231,-0.6391171796346937,-0.0630926071148501,91056943,-1.0
1362,IBM,1557810000000,133.31,134.32,131.68,131.82,3280374,1.8900000000000148,0.0,1.8900000000000148,30.717472798975535,130.96,141.81,21.658986175115167,-78.34101382488483,-1.7128759609533688,-0.8538689358984288,-0.051579396698918645,94337317,1.0
1363,IBM,1557896400000,134.4,134.59,132.37,132.59,2551009,1.0900000000000034,0.0,1.0900000000000034,37.636804924407926,130.96,141.81,31.705069124423957,-68.29493087557604,-1.7692870929663513,-1.0369525673120132,-0.03718031377605846,96888326,1.0
1364,IBM,1557982800000,135.88,136.11,134.64,134.74,3017472,1.4799999999999898,0.0,1.4799999999999898,46.07439809751088,130.96,141.81,45.34562211981557,-54.65437788018443,-1.6752583548801283,-1.1646137248256363,-0.031158645276292418,99905798,1.0
1365,IBM,1558069200000,134.32,135.41,133.94,134.68,2619135,-1.5600000000000023,1.5600000000000023,0.0,39.56408159253441,130.96,141.81,30.96774193548375,-69.03225806451626,-1.70694229677963,-1.273079439216435,-0.043168542527425524,97286663,-1.0
1366,IBM,1558328400000,135.12,135.43,132.9308,133.53,3264649,0.8000000000000114,0.0,0.8000000000000114,44.22721716730282,130.96,141.81,38.341013824884776,-61.65898617511522,-1.648495900298883,-1.3481627314329248,-0.018308631211856885,100551312,1.0
1367,IBM,1558414800000,136.45,137.06,135.79,136.12,2503504,1.329999999999984,0.0,1.329999999999984,51.417880198685246,130.96,141.28,53.1976744186045,-46.8023255813955,-1.4778214198619537,-1.3740944691187307,-0.011231884057971042,103054816,1.0
1368,IBM,1558501200000,136.35,136.75,135.7116,136.0,1849821,-0.09999999999999432,0.09999999999999432,0.0,50.849123713523596,130.96,141.0,53.68525896414334,-46.31474103585666,-1.3352380358174685,-1.3663231824584783,0.00746268656716409,101204995,-1.0
1369,IBM,1558587600000,132.39,135.13,130.44,135.13,5343437,-3.960000000000008,3.960000000000008,0.0,33.77729216811754,130.44,140.69,19.024390243902328,-80.97560975609768,-1.5242084553172504,-1.397900237030233,-0.02165237954478283,95861558,-1.0
1370,IBM,1558674000000,132.28,134.245,131.59,133.53,2596121,-0.10999999999998522,0.10999999999998522,0.0,33.417693134187886,130.44,139.51,20.286659316427837,-79.71334068357217,-1.6636672346368186,-1.4510536365515503,0.0065439050372850804,93265437,-1.0
1371,IBM,1559019600000,130.46,132.64,130.27,132.13,4909121,-1.8199999999999932,1.8199999999999932,0.0,27.772970267392793,130.27,138.7,2.2538552787662898,-97.7461447212337,-1.8991558254467975,-1.5406740743306,-0.021378741279723945,88356316,-1.0
1372,IBM,1559106000000,129.69,130.28,128.32,130.0,3678978,-0.7700000000000102,0.7700000000000102,0.0,25.657316330038384,128.32,137.06,15.675057208238021,-84.32494279176198,-2.1234371336261404,-1.6572266861897083,-0.03504464285714293,84677338,-1.0
1373,IBM,1559192400000,129.57,129.97,128.93,129.74,2741880,-0.12000000000000455,0.12000000000000455,0.0,25.310608763505925,128.32,137.06,14.302059496567491,-85.6979405034325,-2.2845300430700206,-1.782687357565771,-0.04643803355902265,81935458,-1.0
1374,IBM,1559278800000,126.99,128.44,126.85,128.44,3539343,-2.5799999999999983,2.5799999999999983,0.0,18.956040102603225,126.85,137.06,1.371204701273266,-98.62879529872673,-2.590519871915461,-1.944253860435709,-0.05457117331745087,78396115,-1.0
1375,IBM,1559538000000,128.27,128.56,127.06,127.1,4267080,1.2800000000000153,0.0,1.2800000000000153,29.140125554446143,126.85,137.06,13.907933398628941,-86.09206660137106,-2.6986256367156045,-2.0951282156916884,-0.05069567791592655,82663195,1.0
1376,IBM,1559624400000,132.69,132.74,129.085,129.56,3913535,4.4199999999999875,0.0,4.4199999999999875,52.781538202957634,126.85,137.06,57.19882468168461,-42.80117531831539,-2.399977724388634,-2.156098117431078,-0.027555881275192262,86576730,1.0
1377,IBM,1559710800000,131.49,133.61,130.47,133.38,3161584,-1.1999999999999886,1.1999999999999886,0.0,47.7870587654683,126.85,137.06,45.44564152791392,-54.554358472086086,-2.234370639524002,-2.1717526218496626,-0.035643564356435564,83415146,-1.0
1378,IBM,1559797200000,132.22,132.65,130.9,132.19,2298248,0.7299999999999898,0.0,0.7299999999999898,51.0390372014144,126.85,137.06,52.595494613124394,-47.404505386875606,-2.0209249674560112,-2.1415870909709325,-0.0012840849006721111,85713394,1.0
1379,IBM,1559883600000,133.31,134.72,132.21,132.47,2553398,1.0900000000000034,0.0,1.0900000000000034,55.78368114343311,126.85,137.06,63.271302644466246,-36.72869735553376,-1.7437134013918865,-2.062012353055123,0.007786513456304878,88266792,1.0
1380,IBM,1560142800000,134.74,135.3526,133.91,134.38,2911327,1.4300000000000068,0.0,1.4300000000000068,61.440162028488,126.85,137.06,77.27717923604318,-22.72282076395682,-1.3925794006135561,-1.9281257625668096,0.0328069906484747,91178119,1.0
1381,IBM,1560229200000,135.95,136.46,135.05,135.32,3407345,1.2099999999999795,0.0,1.2099999999999795,65.72152871539933,126.85,136.75,91.91919191919182,-8.080808080808191,-1.0050803470053324,-1.7435166794545143,0.04826894903230783,94585464,1.0
1382,IBM,1560315600000,134.87,135.94,134.41,135.56,2254741,-1.079999999999984,1.079999999999984,0.0,58.97749351200813,126.85,136.46,83.45473465140478,-16.545265348595226,-0.7761841614489526,-1.550050175853402,0.040904530369684444,92330723,-1.0
1383,IBM,1560402000000,135.76,136.27,135.09,135.13,2955419,0.8899999999999864,0.0,0.8899999999999864,62.624322539907524,126.85,136.46,92.71592091571263,-7.2840790842873675,-0.5170069885891166,-1.3434415384005451,0.0690605559492874,95286142,1.0
1384,IBM,1560488400000,135.15,135.88,134.43,135.44,2193367,-0.6099999999999852,0.6099999999999852,0.0,58.51077256144319,126.85,136.46,86.36836628511966,-13.631633714880337,-0.35671710115093447,-1.146096650950623,0.053636859748966925,93092775,-1.0
1385,IBM,1560747600000,134.95,136.03,134.7,135.39,2194129,-0.20000000000001705,0.20000000000001705,0.0,57.092050104854586,126.85,136.46,84.287200832466,-15.712799167533998,-0.2430231198115962,-0.9654819447228176,0.01703218026980169,90898646,-1.0
1386,IBM,1560834000000,136.38,137.19,135.2,135.2,2914698,1.4300000000000068,0.0,1.4300000000000068,64.2445492770504,126.85,137.19,92.16634429400385,-7.833655705996151,-0.03710307038835481,-0.779806169855925,0.03718913985854422,93813344,1.0
1387,IBM,1560920400000,137.08,138.36,136.24,136.43,2382520,0.700000000000017,0.0,0.700000000000017,67.32131567440365,126.85,138.36,88.87923544743703,-11.12076455256298,0.18049358452029196,-0.5877462189806816,0.03675692028437472,96195864,1.0
1388,IBM,1561006800000,138.85,139.54,138.2,138.93,3071017,1.7699999999999818,0.0,1.7699999999999818,73.87917733202575,127.06,139.54,94.47115384615385,-5.528846153846141,0.4901149684570498,-0.37217398149313524,0.04155727252269137,99266881,1.0
1389,IBM,1561093200000,139.2,139.54,138.39,138.44,5288759,0.3499999999999943,0.0,0.3499999999999943,75.0228034464026,129.085,139.54,96.74796747967476,-3.252032520325241,0.755030696972085,-0.14673304580009114,0.03310078670031147,104555640,1.0
1390,IBM,1561352400000,139.35,140.15,139.05,139.2,2186137,0.15000000000000568,0.0,0.15000000000000568,75.55211291802605,130.47,140.15,91.73553719008252,-8.264462809917466,0.9659472284642447,0.07580300905277611,0.02500919455682249,106741777,1.0
1391,IBM,1561438800000,138.36,139.55,138.13,139.46,2801251,-0.9899999999999807,0.9899999999999807,0.0,65.05357160231426,130.9,140.15,80.64864864864873,-19.351351351351266,1.0412129186251775,0.2688849909672565,0.025876770223177914,103940526,-1.0
1392,IBM,1561525200000,138.52,139.68,138.4073,138.87,2284567,0.1599999999999966,0.0,0.1599999999999966,65.9362599071312,132.21,140.15,79.471032745592,-20.52896725440801,1.1010796226700563,0.4353239173078165,0.02032999410724834,106225093,1.0
1393,IBM,1561611600000,138.52,139.3,137.95,138.72,2149824,0.0,0.0,0.0,65.93625990713122,133.91,140.15,73.87820512820524,-26.121794871794762,1.1354358195978307,0.5753462977658194,0.024935257121716736,106225093,0.0
1394,IBM,1561698000000,137.9,139.14,137.84,138.57,6154039,-0.6200000000000045,0.6200000000000045,0.0,58.33475663673548,134.41,140.15,60.80139372822306,-39.198606271776946,1.0999549389048298,0.6802680259936215,0.021859948128936768,100071054,-1.0
1395,IBM,1561957200000,139.88,141.49,139.28,139.6,3387184,1.9799999999999898,0.0,1.9799999999999898,70.75737091883283,134.41,141.49,77.25988700564956,-22.740112994350433,1.2175701470353317,0.7877284502019636,0.02566358703622229,103458238,1.0
1396,IBM,1562043600000,140.22,140.43,139.47,139.75,2410092,0.3400000000000034,0.0,0.3400000000000034,72.38850844403333,134.43,141.49,82.01133144475907,-17.988668555240935,1.3229658782254887,0.8947759358066687,0.02290633206886472,105868330,1.0
1397,IBM,1562130000000,141.54,141.82,140.43,140.72,1930361,1.3199999999999932,0.0,1.3199999999999932,77.90853941758697,134.43,141.82,96.21109607577806,-3.7889039242219438,1.495763492369008,1.0149734471191365,0.019373424558876362,107798691,1.0
1398,IBM,1562302800000,141.38,141.49,139.91,140.87,2135085,-0.1599999999999966,0.1599999999999966,0.0,75.78942589651436,134.7,141.82,93.82022471910116,-6.17977528089884,1.6013369679245386,1.1322461512802169,0.015660919540229967,105663606,-1.0
1399,IBM,1562562000000,140.57,141.285,140.27,141.05,2395487,-0.8100000000000023,0.8100000000000023,0.0,65.39858996009684,135.2,141.82,81.11782477341391,-18.88217522658609,1.6011869904490084,1.2260343191139753,0.008754933620380267,103268119,-1.0
1400,IBM,1562648400000,139.33,140.99,139.13,140.61,3365227,-1.2399999999999807,1.2399999999999807,0.0,52.648518985808586,136.24,141.82,55.376344086021724,-44.623655913978276,1.4839049626211818,1.2776084478154166,0.007010696733159794,99902892,-1.0
1401,IBM,1562734800000,140.47,141.91,139.79,140.0,2513931,1.1399999999999864,0.0,1.1399999999999864,60.76316003598746,137.84,141.91,64.61916461916462,-35.380835380835386,1.4660469070566648,1.3152961396636664,0.014077389546635732,102416823,1.0
1402,IBM,1562821200000,141.24,141.58,140.3,140.79,2133327,0.7700000000000102,0.0,0.7700000000000102,65.3861169818494,137.84,141.91,83.53808353808382,-16.461916461916182,1.4967729671465122,1.3515915051602356,0.019636153624025487,104550150,1.0
1403,IBM,1562907600000,142.74,142.92,141.66,141.92,2786276,1.5,0.0,1.5,72.63366241249116,137.84,142.92,96.45669291338625,-3.543307086613759,1.623446969015788,1.4059625979313461,0.03509789702683097,107336426,1.0
1404,IBM,1563166800000,143.32,143.51,142.12,142.89,2368309,0.5799999999999841,0.0,0.5799999999999841,74.97172525414817,137.84,143.51,96.64902998236334,-3.3509700176366515,1.7504599679844262,1.4748620719419623,0.02459250786388334,109704735,1.0
1405,IBM,1563253200000,143.53,144.04,143.02,143.17,3474688,0.21000000000000796,0.0,0.21000000000000796,75.83426423273173,137.84,144.04,91.77419354838723,-8.225806451612772,1.8467754518717072,1.5492447479279114,0.023605762373413164,113179423,1.0
1406,IBM,1563339600000,143.07,143.8,141.95,143.61,6064265,-0.46000000000000796,0.46000000000000796,0.0,69.75810772928209,137.84,144.04,84.35483870967741,-15.64516129032259,1.8644952702805995,1.6122948523984493,0.01080966511233572,107115158,-1.0
1407,IBM,1563426000000,149.63,150.31,142.2,142.5,12695387,6.560000000000002,0.0,6.560000000000002,86.95587965972999,137.84,150.31,94.54691259021646,-5.453087409783536,2.380435352848423,1.7659229524884443,0.05835337388598094,119810545,1.0
1408,IBM,1563512400000,149.68,151.58,149.55,149.96,7290678,0.05000000000001137,0.0,0.05000000000001137,87.02079173532421,139.13,151.58,84.73895582329315,-15.261044176706854,2.761523048844907,1.9650429717597369,0.06480756918261377,127101223,1.0
1409,IBM,1563771600000,149.74,151.94,149.7,150.16,4093239,0.060000000000002274,0.0,0.060000000000002274,87.10961073640445,139.13,151.94,82.82591725214685,-17.17408274785315,3.033412006690071,2.178716778745804,0.07471470609344721,131194462,1.0
1410,IBM,1563858000000,150.38,150.72,148.38,150.57,3742204,0.6399999999999864,0.0,0.6399999999999864,88.11095047103463,139.13,151.94,87.82201405152223,-12.177985948477767,3.26291575421331,2.3955565738393054,0.07054887164519119,134936666,1.0
1411,IBM,1563944400000,150.03,151.45,149.195,150.12,2952435,-0.3499999999999943,0.3499999999999943,0.0,83.99378296589697,139.13,151.94,85.0897736143638,-14.910226385636191,3.377621929575241,2.591969644986493,0.06223449447748508,131984231,-1.0
1412,IBM,1564030800000,150.39,150.62,148.61,149.82,3102113,0.3599999999999852,0.0,0.3599999999999852,84.83478965850439,139.13,151.94,87.9000780640124,-12.099921935987597,3.4577179709035306,2.7651193101699008,0.05359394703656983,135086344,1.0
1413,IBM,1564117200000,151.36,151.41,150.1,151.0,2904494,0.9700000000000273,0.0,0.9700000000000273,86.96422621798071,139.13,151.94,95.47228727556609,-4.527712724433911,3.5584460036148187,2.923784648858885,0.05609824169690225,137990838,1.0
1414,IBM,1564376400000,150.88,151.48,150.32,151.11,2075528,-0.4800000000000182,0.4800000000000182,0.0,80.50945898370799,139.79,151.94,91.27572016460904,-8.724279835390961,3.5585212884614066,3.0507319767793897,0.05120880652128479,135915310,-1.0
1415,IBM,1564462800000,149.77,150.4,149.22,150.0,2632726,-1.1099999999999852,1.1099999999999852,0.0,67.2005507844697,140.3,151.94,81.35738831615129,-18.642611683848713,3.429480314612306,3.1264816443459735,0.04683022296777817,133282584,-1.0
1416,IBM,1564549200000,148.24,150.18,146.39,149.7,3722907,-1.5300000000000011,1.5300000000000011,0.0,53.21075688337487,141.66,151.94,64.00778210116744,-35.99221789883257,3.1672461577263675,3.1346345470220527,-0.00928958096638366,129559677,-1.0
1417,IBM,1564635600000,150.32,152.82,148.5,148.9,6344006,2.079999999999984,0.0,2.079999999999984,64.72879660838515,141.95,152.82,77.00091996320148,-22.99908003679852,3.0916239988245593,3.1260324373825545,0.00427578834847675,135903683,1.0
1418,IBM,1564722000000,147.25,152.95,145.59,149.03,8101720,-3.069999999999993,3.069999999999993,0.0,45.608293291281804,141.95,152.95,48.18181818181829,-51.81818181818172,2.75224340140781,3.051274630187606,-0.016628823293709183,127801963,-1.0
1419,IBM,1564981200000,140.76,145.1,139.15,144.98,7114871,-6.490000000000009,6.490000000000009,0.0,26.508180435200245,139.15,152.95,11.666666666666574,-88.33333333333343,1.9372615270623896,2.828472009562563,-0.06397127277563508,120687092,-1.0
1420,IBM,1565067600000,140.73,142.47,139.31,142.03,5070650,-0.030000000000001137,0.030000000000001137,0.0,26.44910220020695,139.15,152.95,11.449275362318739,-88.55072463768126,1.2742727477084372,2.5176321571917377,-0.06198760247950419,115616442,-1.0
1421,IBM,1565154000000,139.11,139.58,136.4115,138.74,5931883,-1.6199999999999761,1.6199999999999761,0.0,23.224112140689854,136.4115,152.95,16.31647368261949,-83.68352631738051,0.6110846983831664,2.1363226654300234,-0.07500498703371217,109684559,-1.0
1422,IBM,1565240400000,140.1,140.42,137.76,138.45,5261444,0.9899999999999807,0.0,0.9899999999999807,29.302515210394205,136.4115,152.95,22.302506273241253,-77.69749372675875,0.16350335263393845,1.7417588028708062,-0.07439217758985217,114946003,1.0
1423,IBM,1565326800000,136.13,139.31,135.35,139.27,5244594,-3.969999999999999,3.969999999999999,0.0,21.446209017630622,135.35,152.95,4.43181818181819,-95.56818181818181,-0.5057242356611482,1.2922621951644153,-0.09775980911983029,109701409,-1.0
1424,IBM,1565586000000,133.67,135.87,133.18,135.66,4083850,-2.460000000000008,2.460000000000008,0.0,17.996422711033617,133.18,152.95,2.478502781992823,-97.52149721800718,-1.2205239218107522,0.7897049717693817,-0.10749816385123867,105617559,-1.0
1425,IBM,1565672400000,135.79,136.57,132.8058,133.8,4551170,2.1200000000000045,0.0,2.1200000000000045,29.30435010800406,132.8058,152.95,14.814189692318333,-85.18581030768166,-1.5975262523061815,0.312258726954269,-0.08398542903399908,110168729,1.0
1426,IBM,1565758800000,131.25,134.16,130.98,133.91,5114159,-4.539999999999992,4.539999999999992,0.0,21.85691183563671,130.98,152.95,1.2289485662267194,-98.77105143377328,-2.23685826335182,-0.197564671106949,-0.12686269292176688,105054570,-1.0
1427,IBM,1565845200000,131.92,132.37,130.25,131.22,3738945,0.6699999999999875,0.0,0.6699999999999875,25.098316506237595,130.25,152.95,7.3568281938325475,-92.64317180616746,-2.6588208558992505,-0.6898159080654095,-0.1041086587436334,108793515,1.0
1428,IBM,1565931600000,133.76,134.59,132.9539,133.04,3011993,1.8400000000000034,0.0,1.8400000000000034,33.799793114567535,130.25,152.95,15.462555066079261,-84.53744493392074,-2.8123377491384076,-1.1143202762800095,-0.04973003694231315,111805508,1.0
1429,IBM,1566190800000,135.04,136.33,134.88,134.88,3165436,1.2800000000000011,0.0,1.2800000000000011,39.44632680864178,130.25,152.95,21.10132158590306,-78.89867841409695,-2.7984568221988297,-1.4511475854637736,-0.040432032970937226,114970944,1.0
1430,IBM,1566277200000,133.0,135.28,132.81,135.24,3018934,-2.039999999999992,2.039999999999992,0.0,34.097982420440545,130.25,152.95,12.114537444933928,-87.88546255506607,-2.9184252489874893,-1.744603118168517,-0.04392207605492071,111952010,-1.0
1431,IBM,1566363600000,134.25,135.94,133.8,134.96,2806774,1.25,0.0,1.25,39.862777984836356,130.25,152.95,17.62114537444935,-82.37885462555066,-2.8794440990471344,-1.9715713143442408,-0.04175588865096358,114758784,1.0
1432,IBM,1566450000000,134.32,135.68,133.81,134.69,2695009,0.06999999999999318,0.0,0.06999999999999318,40.20077795954568,130.25,145.1,27.40740740740737,-72.59259259259264,-2.8105050887058383,-2.1393580692165606,-0.013296114008668147,117453793,1.0
1433,IBM,1566536400000,129.57,134.26,128.83,133.63,4818759,-4.75,4.75,0.0,27.915947747314036,128.83,142.47,5.425219941348837,-94.57478005865116,-3.103381874464617,-2.332162830266172,-0.030672551806688042,112635034,-1.0
1434,IBM,1566795600000,129.99,131.3,129.16,131.05,2836837,0.4200000000000159,0.0,0.4200000000000159,30.095383864619393,128.83,140.42,10.008628127696282,-89.99137187230372,-3.2639732949369886,-2.5185249232003355,-0.042713012740260625,115471871,1.0
1435,IBM,1566882000000,131.17,131.6961,130.31,131.2,4728392,1.1799999999999784,0.0,1.1799999999999784,36.33537221460094,128.83,140.42,20.189818809318204,-79.81018119068179,-3.2584654529146633,-2.6665130291432013,-0.0006095238095239486,120200263,1.0
1436,IBM,1566968400000,132.76,132.89,130.04,130.44,2720362,1.5900000000000034,0.0,1.5900000000000034,44.094226693547704,128.83,139.31,37.49999999999983,-62.50000000000016,-3.090179075798403,-2.7512462384742418,0.00636749545178894,122920625,1.0
1437,IBM,1567054800000,134.88,135.69,134.04,134.18,2972842,2.1200000000000045,0.0,2.1200000000000045,52.92119344183121,128.83,136.57,78.16537467700256,-21.834625322997443,-2.753998249558606,-2.751796640691115,0.00837320574162681,125893467,1.0
1438,IBM,1567141200000,135.53,136.07,134.3627,135.58,2960594,0.6500000000000057,0.0,0.6500000000000057,55.411773098428775,128.83,136.57,86.56330749354012,-13.43669250645988,-2.4073722660424437,-2.682911765761381,0.003628554502369763,128854061,1.0
1439,IBM,1567486800000,134.1,134.9013,133.3301,134.85,2828242,-1.4300000000000068,1.4300000000000068,0.0,48.85147918089638,128.83,136.33,70.26666666666642,-29.73333333333358,-2.222438834329864,-2.590817179475078,0.008270676691729317,126025819,-1.0
1440,IBM,1567573200000,136.32,136.43,135.15,135.71,2262081,2.219999999999999,0.0,2.219999999999999,57.80080398687395,128.83,136.43,98.55263157894719,-1.4473684210528122,-1.8751270136509959,-2.4476791463102616,0.015418994413407772,128287900,1.0
1441,IBM,1567659600000,140.97,141.695,138.05,138.3,5012914,4.650000000000006,0.0,4.650000000000006,70.3421620004937,128.83,141.695,94.36455499417026,-5.635445005829735,-1.2107074730775196,-2.2002848116637135,0.04950863609291245,133300814,1.0
1442,IBM,1567746000000,140.57,141.525,140.46,141.52,2577200,-0.4000000000000057,0.4000000000000057,0.0,68.32664966685563,128.83,141.695,91.25534395647104,-8.744656043528968,-0.7082624487185001,-1.9018803390746708,0.08489619510689206,130723614,-1.0
1443,IBM,1568005200000,142.6,143.02,140.46,140.59,4226944,2.030000000000001,0.0,2.030000000000001,72.87741804057023,128.83,143.02,97.04016913319228,-2.9598308668077236,-0.1446002507310027,-1.5504243214059372,0.09700746211247013,134950558,1.0
1444,IBM,1568091600000,145.05,145.46,142.96,143.0,4979741,2.450000000000017,0.0,2.450000000000017,77.39939846881562,128.83,145.46,97.53457606734818,-2.465423932651814,0.49410489299970095,-1.1415184785248096,0.10581687885949553,139930299,1.0
1445,IBM,1568178000000,143.6,145.12,142.7051,144.85,3869731,-1.450000000000017,1.450000000000017,0.0,69.48793415902313,128.83,145.46,88.81539386650623,-11.184606133493771,0.8732145652331837,-0.7385718697732109,0.081651099728834,136060568,-1.0
1446,IBM,1568264400000,143.62,144.04,141.88,144.03,2505432,0.020000000000010232,0.0,0.020000000000010232,69.53749000251517,128.83,145.46,88.93565844858686,-11.064341551413133,1.1618820911684509,-0.35848107758487846,0.06479833926453149,138566000,1.0
1447,IBM,1568350800000,143.67,144.65,143.26,144.32,2206612,0.04999999999998295,0.0,0.04999999999998295,69.67954186567827,129.16,145.46,89.01840490797535,-10.981595092024659,1.378793889651405,-0.011026084137621699,0.06006050320962131,140772612,1.0
1448,IBM,1568610000000,142.48,143.64,142.27,142.56,1928500,-1.1899999999999977,1.1899999999999977,0.0,61.76947711762455,130.04,145.46,80.67444876783388,-19.325551232166116,1.4380975051049916,0.2787986337109011,0.06249067859806101,138844112,-1.0
1449,IBM,1568696400000,142.2,142.48,140.66,142.48,2940494,-0.28000000000000114,0.28000000000000114,0.0,59.92265620056524,130.04,145.46,78.858625162127,-21.141374837872995,1.4458356937925032,0.5122060457272216,0.04313380281690127,135903618,-1.0
1450,IBM,1568782800000,142.22,142.3,140.51,142.05,1995159,0.020000000000010232,0.0,0.020000000000010232,60.02117084670063,133.3301,145.46,73.28914500531741,-26.71085499468259,1.437017058789337,0.6971682483396447,0.008867134851386904,137898777,1.0
1451,IBM,1568869200000,142.97,145.03,142.45,142.46,3182092,0.75,0.0,0.75,63.86456026488163,133.3301,145.46,79.47221329112355,-20.52778670887645,1.4735606688718974,0.8524467324460954,0.017073344241303356,141080869,1.0
1452,IBM,1568955600000,141.88,143.83,141.82,143.25,5217881,-1.0900000000000034,1.0900000000000034,0.0,54.99819011009811,133.3301,145.46,70.48615404908527,-29.513845950914735,1.3984474212856242,0.9616468702140011,-0.005049088359046272,135862988,-1.0
1453,IBM,1569214800000,142.07,142.22,140.558,141.19,1850061,0.18999999999999773,0.0,0.18999999999999773,56.22063804088074,135.15,145.46,67.11930164888444,-32.880698351115555,1.3388179831905518,1.0370810928093115,-0.020544639779386586,137713049,1.0
1454,IBM,1569301200000,141.68,142.89,141.07,142.5,3311171,-0.38999999999998636,0.38999999999998636,0.0,52.82222624168893,138.05,145.46,48.98785425101211,-51.01214574898789,1.2457314663560624,1.0788111675186618,-0.013370473537604344,134401878,-1.0
1455,IBM,1569387600000,143.16,143.63,140.8588,141.74,2546205,1.4799999999999898,0.0,1.4799999999999898,62.695954672942925,140.46,145.46,53.99999999999977,-46.00000000000023,1.2766667427238474,1.118382282559699,-0.003202896532516375,136948083,1.0
1456,IBM,1569474000000,143.55,143.88,141.41,143.17,2314542,0.3900000000000148,0.0,0.3900000000000148,64.92776834703432,140.46,145.46,61.80000000000007,-38.19999999999993,1.3174659849752572,1.1581990230428107,-0.000835247442054543,139262625,1.0
1457,IBM,1569560400000,143.24,145.09,142.38,144.41,2357082,-0.3100000000000023,0.3100000000000023,0.0,61.55040406673498,140.51,145.46,55.151515151515326,-44.848484848484674,1.309688001155422,1.188496818665333,0.005334081976417826,136905543,-1.0
1458,IBM,1569819600000,145.42,146.57,143.73,143.73,4004429,2.1799999999999784,0.0,2.1799999999999784,72.96233841372734,140.51,146.57,81.02310231023094,-18.97689768976906,1.4625720537050313,1.243311865673273,0.022644163150492336,140909972,1.0
1459,IBM,1569906000000,143.66,147.35,143.54,145.59,2973714,-1.759999999999991,1.759999999999991,0.0,57.15879055144322,140.51,147.35,46.05263157894743,-53.947368421052566,1.4252866583669288,1.2797068242120042,0.010125158205597007,137936258,-1.0
1460,IBM,1569992400000,141.69,142.2659,140.57,142.19,3347276,-1.9699999999999989,1.9699999999999989,0.0,44.66431583531197,140.51,147.35,17.251461988304186,-82.74853801169581,1.2226808738898853,1.2683016341475806,-0.00895292718752183,134588982,-1.0
1461,IBM,1570078800000,142.02,142.07,139.18,141.62,3161718,0.3300000000000125,0.0,0.3300000000000125,46.90749423878435,139.18,147.35,34.76132190942482,-65.23867809057518,1.076335249312251,1.2299083571805147,0.0009867493656612325,137750700,1.0
1462,IBM,1570165200000,142.99,143.06,141.03,142.06,2449483,0.9699999999999989,0.0,0.9699999999999989,53.32476996032041,139.18,147.35,46.634026927784674,-53.365973072215326,1.0267899850498736,1.1892846827543866,0.006475681002322986,140200183,1.0
1463,IBM,1570424400000,141.28,142.7,141.22,142.26,2488799,-1.710000000000008,1.710000000000008,0.0,42.80153817883115,139.18,147.35,25.70379436964501,-74.29620563035499,0.8398609035331788,1.1193999269101451,-0.0028232636928289256,137711384,-1.0
1464,IBM,1570510800000,138.38,140.4749,138.25,140.24,3344083,-2.9000000000000057,2.9000000000000057,0.0,30.877723576249167,138.25,147.35,1.4285714285713795,-98.57142857142863,0.45249639917076934,0.9860192213622699,-0.033389214864487315,134367301,-1.0
1465,IBM,1570597200000,139.67,140.33,138.79,139.77,2633472,1.289999999999992,0.0,1.289999999999992,39.524860502357036,138.25,147.35,15.604395604395476,-84.39560439560452,0.24675501940905065,0.8381663809716261,-0.027028909787530586,137000773,1.0
1466,IBM,1570683600000,141.13,141.78,139.56,139.77,2646693,1.460000000000008,0.0,1.460000000000008,48.01716095119567,138.25,147.35,31.648351648351618,-68.3516483516484,0.19921684416090102,0.7103764736094811,-0.01473052220050275,139647466,1.0
1467,IBM,1570770000000,142.76,144.5,142.61,142.77,3018669,1.6299999999999955,0.0,1.6299999999999955,55.98020538538472,138.25,147.35,49.56043956043949,-50.4395604395605,0.2897300476655005,0.626247188420685,-0.01829184431302433,142666135,1.0
1468,IBM,1571029200000,142.04,142.43,141.32,142.31,2325609,-0.7199999999999989,0.7199999999999989,0.0,51.92607736091408,138.25,147.35,41.64835164835159,-58.35164835164841,0.29990728633529784,0.5609792080036077,-0.011276625365446269,140340526,-1.0
1469,IBM,1571115600000,143.0,143.72,141.81,142.54,3046999,0.960000000000008,0.0,0.960000000000008,56.74535919506291,138.25,147.35,52.19780219780223,-47.802197802197774,0.3810443561041268,0.5249922376237115,0.009245536029359958,143387525,1.0
1470,IBM,1571202000000,142.11,142.95,141.3905,142.49,5915705,-0.8899999999999864,0.8899999999999864,0.0,51.24957451580016,138.25,147.35,42.417582417582594,-57.58241758241741,0.36927374858845496,0.4938485398166602,0.0006337135614702394,137471820,-1.0
1471,IBM,1571288400000,134.26,136.0,132.91,135.0,15830810,-7.850000000000023,7.850000000000023,0.0,25.809850207711406,132.91,147.35,9.349030470914089,-90.65096952908591,-0.27036731141481596,0.341005369570365,-0.06105322050493056,121641010,-1.0
1472,IBM,1571374800000,134.09,134.49,132.25,134.22,7178379,-0.1699999999999875,0.1699999999999875,0.0,25.493636209124034,132.25,147.35,12.185430463576186,-87.81456953642382,-0.7819907366434506,0.11640614832760181,-0.050891845979614936,114462631,-1.0
1473,IBM,1571634000000,132.58,133.1,130.9,132.61,6372983,-1.509999999999991,1.509999999999991,0.0,22.649617711096738,130.9,144.5,12.352941176470642,-87.64705882352935,-1.2943795656784687,-0.16575099447361238,-0.04191357132533591,108089648,-1.0
1474,IBM,1571720400000,133.96,134.05,131.61,132.55,4195803,1.3799999999999955,0.0,1.3799999999999955,30.79125335424426,130.9,144.5,22.500000000000025,-77.49999999999997,-1.570987570584208,-0.4467983096957316,-0.0408820791866541,112285451,1.0
1475,IBM,1571806800000,134.38,134.565,132.7,133.52,3627345,0.4199999999999875,0.0,0.4199999999999875,33.25822995046475,130.9,144.5,25.588235294117585,-74.41176470588242,-1.7362959781817722,-0.7046978433929398,-0.04782824346347336,115912796,1.0
1476,IBM,1571893200000,134.07,135.07,133.3,134.83,2619309,-0.3100000000000023,0.3100000000000023,0.0,32.2783438464167,130.9,144.5,23.308823529411683,-76.69117647058832,-1.8707536083145442,-0.9379089963772609,-0.06087139254693186,113293487,-1.0
1477,IBM,1571979600000,135.44,135.93,134.1,134.12,2579055,1.3700000000000045,0.0,1.3700000000000045,41.123849315773334,130.9,144.5,33.38235294117642,-66.61764705882356,-1.8454910266998752,-1.1194254024417838,-0.046465784286116585,115872542,1.0
1478,IBM,1572238800000,135.97,136.63,135.445,136.0,3226132,0.5300000000000011,0.0,0.5300000000000011,44.367449137301286,130.9,144.5,37.27941176470585,-62.72058823529415,-1.7623879667260098,-1.248017915298629,-0.04916083916083913,119098674,1.0
1479,IBM,1572325200000,133.82,135.57,133.44,135.42,4160718,-2.1500000000000057,2.1500000000000057,0.0,35.271928522555186,130.9,144.5,21.470588235294034,-78.52941176470597,-1.8487045098607098,-1.3681552342110452,-0.05833509253395275,114937956,-1.0
1480,IBM,1572411600000,135.25,135.28,133.2,133.83,2252989,1.4300000000000068,0.0,1.4300000000000068,44.071153976735474,130.9,144.5,31.98529411764703,-68.01470588235297,-1.7811894993837711,-1.4507620872455906,0.007373752420676283,117190945,1.0
1481,IBM,1572498000000,133.73,135.25,133.23,135.11,3412119,-1.5200000000000102,1.5200000000000102,0.0,37.773305270639284,130.9,143.72,22.0748829953197,-77.9251170046803,-1.8292482290740963,-1.526459315611292,-0.0026847639645015686,113778826,-1.0
1482,IBM,1572584400000,135.53,135.56,134.09,134.5,3089789,1.8000000000000114,0.0,1.8000000000000114,47.93880547536971,130.9,143.72,36.115444617784696,-63.884555382215304,-1.702465202716695,-1.5616604930323728,0.02225071654849886,116868615,1.0
1483,IBM,1572847200000,137.67,137.74,136.23,136.24,3335389,2.1399999999999864,0.0,2.1399999999999864,57.469807172018676,130.9,142.95,56.18257261410782,-43.81742738589219,-1.413020208246195,-1.5319324360751374,0.02769483427888897,120204004,1.0
1484,IBM,1572933600000,137.89,138.76,137.63,137.8,3014961,0.21999999999999886,0.0,0.21999999999999886,58.37376539562449,130.9,138.76,88.93129770992358,-11.068702290076414,-1.1525944124844045,-1.456064831356991,0.026119958327131876,123218965,1.0
1485,IBM,1573020000000,138.78,138.78,137.55,138.0,4477291,0.8900000000000148,0.0,0.8900000000000148,62.13085647821234,130.9,138.78,100.0,-0.0,-0.8644249780558653,-1.3377368606967661,0.03513090176773326,127696256,1.0
1486,IBM,1573106400000,137.69,139.135,137.58,137.87,4073908,-1.0900000000000034,1.0900000000000034,0.0,55.10269352020377,130.9,139.135,82.45294474802677,-17.547055251973234,-0.7157517746938424,-1.2133398434961815,0.016612522150029507,123622348,-1.0
1487,IBM,1573192800000,137.61,137.61,136.16,137.58,2278602,-0.07999999999998408,0.07999999999998408,0.0,54.579842265819934,131.61,139.135,79.73421926910324,-20.26578073089677,-0.5974949712085618,-1.0901708690386576,0.01206148415091568,121343746,-1.0
1488,IBM,1573452000000,135.47,137.2,135.0,137.2,2568755,-2.140000000000015,2.140000000000015,0.0,42.21598581369462,132.7,139.135,43.04584304584319,-56.95415695415681,-0.6687468206578728,-1.0058860593625005,0.012329995516365377,118774991,-1.0
1489,IBM,1573538400000,135.59,136.66,135.02,135.87,3046536,0.12000000000000455,0.0,0.12000000000000455,43.05067661224948,133.2,139.135,40.26958719460849,-59.73041280539151,-0.7073772232673434,-0.9461842921434691,0.002513863216266232,121821527,1.0
1490,IBM,1573624800000,134.48,135.58,133.845,135.39,3060924,-1.1100000000000136,1.1100000000000136,0.0,37.30002933624795,133.2,139.135,21.5669755686605,-78.4330244313395,-0.8181289378671579,-0.9205732212882068,0.005608315262095376,118760603,-1.0
1491,IBM,1573711200000,134.0,134.33,133.33,134.13,4231471,-0.47999999999998977,0.47999999999998977,0.0,34.96931000971466,133.2,139.135,13.479359730412993,-86.520640269587,-0.93386741582583,-0.9232320601957316,-0.01128901350254552,114529132,-1.0
1492,IBM,1573797600000,134.4,135.12,134.03,134.39,3262656,0.4000000000000057,0.0,0.4000000000000057,38.65506270333972,133.2,139.135,20.21903959561949,-79.78096040438051,-0.9819945149008333,-0.9349845511367519,-0.023752451514491013,117791788,1.0
1493,IBM,1574056800000,134.31,134.48,133.23,134.3,3210872,-0.09000000000000341,0.09000000000000341,0.0,38.09453010385909,133.2,139.135,18.70261162594799,-81.29738837405202,-1.0156895980518925,-0.9511255605197801,-0.02596272391036325,114580916,-1.0
1494,IBM,1574143200000,134.52,135.38,134.46,134.88,2995071,0.21000000000000796,0.0,0.21000000000000796,40.42056159719549,133.23,139.135,21.84589331075394,-78.15410668924606,-1.0137619327365996,-0.963652834963144,-0.03069606571552086,117575987,1.0
1495,IBM,1574229600000,133.2,134.4614,132.75,134.06,4140148,-1.3200000000000216,1.3200000000000216,0.0,31.764330922206838,132.75,139.135,7.047768206734366,-92.95223179326564,-1.1059979564042806,-0.9921218592513714,-0.03260948507516892,113435839,-1.0
1496,IBM,1574316000000,133.84,134.17,132.98,133.4,3345343,0.6400000000000148,0.0,0.6400000000000148,39.06476851475045,132.75,139.135,17.071260767423727,-82.92873923257628,-1.1146045509427154,-1.0166183975896401,-0.027396264806336834,116781182,1.0
1497,IBM,1574402400000,134.34,134.65,133.59,134.19,3297797,0.5,0.0,0.5,44.42467695906396,132.75,139.135,24.90211433046211,-75.09788566953789,-1.0687595232911349,-1.027046622729939,-0.008341330183804452,120078979,1.0
1498,IBM,1574661600000,135.97,136.0,134.35,134.47,2590170,1.6299999999999955,0.0,1.6299999999999955,58.24128742677084,132.75,139.135,50.43069694596717,-49.56930305403284,-0.8906329685978278,-0.9997638919035168,0.002802566560955899,122669149,1.0
1499,IBM,1574748000000,135.09,136.15,134.77,136.15,3793337,-0.8799999999999955,0.8799999999999955,0.0,50.43110813839794,132.75,139.135,36.64839467501969,-63.35160532498032,-0.8111248933412583,-0.9620360921910652,0.004535990481856045,118875812,-1.0
1500,IBM,1574834400000,133.77,135.71,133.62,135.35,3282827,-1.3199999999999932,1.3199999999999932,0.0,40.9311241149421,132.75,137.61,20.987654320987804,-79.0123456790122,-0.8448877985580054,-0.9386064334644534,-0.0017164179104476318,115592985,-1.0
1501,IBM,1575007200000,134.45,134.52,133.03,133.6,1825255,0.6799999999999784,0.0,0.6799999999999784,46.879142829659656,132.75,137.2,38.20224719101108,-61.797752808988925,-0.8074668519494139,-0.9123785171614456,0.00037202380952372494,117418240,1.0
1502,IBM,1575266400000,132.91,134.5,132.48,134.45,3067831,-1.539999999999992,1.539999999999992,0.0,37.11342146795924,132.48,136.66,10.287081339713065,-89.71291866028693,-0.8917955478891031,-0.9082619233069771,-0.010423646787283247,114350409,-1.0
1503,IBM,1575352800000,132.12,132.44,130.689,132.0,3711071,-0.789999999999992,0.789999999999992,0.0,33.039502027873255,130.689,136.15,26.20399194286776,-73.79600805713224,-1.0107220698032506,-0.9287539526062317,-0.017841213202497763,110639338,-1.0
1504,IBM,1575439200000,131.99,133.68,131.96,132.86,3530773,-0.12999999999999545,0.12999999999999545,0.0,32.36494224159357,130.689,136.15,23.82347555392809,-76.17652444607191,-1.1027502898806745,-0.9635532200611203,-0.009084084084083899,107108565,-1.0
1505,IBM,1575525600000,131.91,133.24,131.6264,132.99,3598578,-0.0800000000000125,0.0800000000000125,0.0,31.902448865656325,130.689,136.15,22.358542391503402,-77.6414576084966,-1.1686669832190546,-1.0045759726927073,-0.01442020322773463,103509987,-1.0
1506,IBM,1575612000000,133.22,133.89,132.7,132.75,3437994,1.3100000000000023,0.0,1.3100000000000023,46.3797794646053,130.689,136.15,46.34682292620399,-53.65317707379601,-1.1024915494161291,-1.0241590880373916,-0.008337055232990997,106947981,1.0
1507,IBM,1575871200000,133.92,134.59,133.26,133.35,2978801,0.6999999999999886,0.0,0.6999999999999886,52.59372547623037,130.689,136.15,59.16498809741781,-40.83501190258218,-0.9822402374689432,-1.015775317923702,-0.015076855188644656,109926782,1.0
1508,IBM,1575957600000,133.91,134.84,133.56,133.92,3480385,-0.009999999999990905,0.009999999999990905,0.0,52.49345020050746,130.689,136.15,58.98187145211493,-41.01812854788508,-0.8776303464850344,-0.9881463236359684,-0.00873491746243249,106446397,-1.0
1509,IBM,1576044000000,133.76,134.51,133.67,134.11,3953311,-0.15000000000000568,0.15000000000000568,0.0,50.816561005237155,130.689,136.15,56.23512177256897,-43.76487822743104,-0.7976353567228784,-0.9500441302533505,-7.475517679611521e-05,102493086,-1.0
1510,IBM,1576130400000,135.32,135.6604,133.66,133.7,4824186,1.5600000000000023,0.0,1.5600000000000023,64.4457954207872,130.689,136.15,84.80131843984599,-15.198681560154013,-0.6014269133852963,-0.8803206868797397,0.006470806991446754,107317272,1.0
1511,IBM,1576216800000,134.21,135.5,134.01,134.75,2534970,-1.1099999999999852,1.1099999999999852,0.0,52.50127523624423,130.689,136.15,64.47537081120687,-35.52462918879314,-0.5293954901050313,-0.8101356475247982,0.009781054849146154,104782302,-1.0
13,JPM,1514959200000,108.06,108.49,107.48,107.86,11901037,0.10999999999999943,0.0,0.10999999999999943,64.86573478969869,104.64,108.49,88.83116883116901,-11.168831168830993,0.22069341569601875,0.11866562020722386,0.014552624166744854,27625924,1.0
14,JPM,1515045600000,109.04,110.03,108.2,108.36,12953656,0.980000000000004,0.0,0.980000000000004,72.6138047500836,104.64,110.03,81.63265306122459,-18.367346938775412,0.298886915403898,0.1547098792465587,0.02732240437158473,40579580,1.0
15,JPM,1515132000000,108.34,109.55,107.775,109.26,14154974,-0.7000000000000028,0.7000000000000028,0.0,61.44581866468445,105.2,110.03,65.01035196687374,-34.98964803312626,0.31200820803941554,0.1861695450051301,0.004729667068533949,26424606,-1.0
16,JPM,1515391200000,108.5,108.68,107.7,108.15,12466512,0.1599999999999966,0.0,0.1599999999999966,62.9487142338554,106.09,110.03,61.167512690355274,-38.83248730964472,0.32804455453546666,0.21454454691119745,0.009771986970684043,38891118,1.0
17,JPM,1515477600000,109.05,109.63,108.49,108.72,13292310,0.5499999999999972,0.0,0.5499999999999972,67.91023158871124,106.09,110.03,75.12690355329937,-24.873096446700625,0.3709760816336569,0.2458308538556894,0.018968417118295555,52183428,1.0
18,JPM,1515564000000,110.25,110.7,109.39,109.47,15834468,1.2000000000000028,0.0,1.2000000000000028,76.00073625952841,106.09,110.7,90.23861171366589,-9.76138828633412,0.47643568005510417,0.2919518190955724,0.028259653049804045,68017896,1.0
19,JPM,1515650400000,110.84,110.929,110.051,110.67,13676788,0.5900000000000034,0.0,0.5900000000000034,79.00382331012413,106.4,110.929,98.03488628836391,-1.9651137116360942,0.5904278705185249,0.3516470293801629,0.028295760274607895,81694684,1.0
20,JPM,1515736800000,112.67,112.85,110.84,111.65,18884229,1.8299999999999983,0.0,1.8299999999999983,85.49821470582286,106.4,112.85,97.2093023255815,-2.790697674418495,0.792496293607357,0.4398168822256018,0.05358144754067706,100578913,1.0
21,JPM,1516082400000,112.27,113.43,111.07,111.51,22703336,-0.4000000000000057,0.4000000000000057,0.0,79.31108871746761,106.4,113.43,83.49928876244651,-16.500711237553496,0.9126664237131052,0.5343867905231026,0.04001852709587772,77875577,-1.0
22,JPM,1516168800000,112.99,113.2958,111.31,111.89,14940266,0.7199999999999989,0.0,0.7199999999999989,82.01429826270487,106.67,113.43,93.49112426035487,-6.508875739645142,1.0439595774926005,0.6363013479170022,0.045622802146955355,92815843,1.0
23,JPM,1516255200000,113.26,113.7226,112.27,112.76,14572911,0.27000000000001023,0.0,0.27000000000001023,82.97671804633083,106.8056,113.7226,93.31212953592606,-6.687870464073943,1.1521716476638915,0.7394754078663801,0.03870139398385919,107388754,1.0
24,JPM,1516341600000,113.01,114.34,112.804,113.94,18785468,-0.25,0.25,0.0,78.48954207544693,106.8056,114.34,82.34763219367173,-17.65236780632827,1.2053973153650048,0.8326597893661052,0.04310503968986534,88603286,-1.0
25,JPM,1516600800000,114.33,114.39,112.5,112.66,12475654,1.3199999999999932,0.0,1.3199999999999932,83.8201170194998,106.8056,114.39,99.20890248404616,-0.7910975159538296,1.325390300159171,0.9312058915247184,0.0537327188940091,101078940,1.0
26,JPM,1516687200000,114.21,114.64,113.35,113.67,12320751,-0.12000000000000455,0.12000000000000455,0.0,81.69646724328129,107.48,114.64,93.99441340782113,-6.00558659217887,1.39488848355262,1.023942409930299,0.04731774415405776,88758189,-1.0
27,JPM,1516773600000,115.67,116.0,114.66,114.86,15904504,1.460000000000008,0.0,1.460000000000008,86.49859014622302,107.7,116.0,96.0240963855422,-3.9759036144578124,1.5372170952446282,1.126597346993165,0.049160997732426326,104662693,1.0
28,JPM,1516860000000,115.7,116.17,115.075,116.04,13509957,0.030000000000001137,0.0,0.030000000000001137,86.58205443204274,107.7,116.17,94.45100354191266,-5.5489964580873545,1.6325523266597486,1.2277883429264818,0.043846986647419595,118172650,1.0
29,JPM,1516946400000,116.32,116.32,114.96,115.7,13883875,0.6199999999999903,0.0,0.6199999999999903,88.30592888145034,107.7,116.32,100.0,-0.0,1.73305954939093,1.3288425842193716,0.03239549125765495,132056525,1.0
30,JPM,1517205600000,116.2,117.3529,116.02,116.02,11679919,-0.11999999999999034,0.11999999999999034,0.0,85.84294439850322,108.49,117.3529,86.99184239921469,-13.008157600785308,1.7827028001380398,1.4196146274031054,0.03500489890442693,120376606,-1.0
31,JPM,1517292000000,115.11,116.6,114.98,115.53,14279124,-1.0900000000000034,1.0900000000000034,0.0,66.42523245719514,109.39,117.3529,71.83312612239254,-28.16687387760746,1.7206334800100365,1.4798183979244919,0.018762722364811024,106097482,-1.0
32,JPM,1517378400000,115.67,116.66,115.16,115.65,13141423,0.5600000000000023,0.0,0.5600000000000023,70.39502315891797,110.051,117.3529,76.95257398759223,-23.04742601240777,1.6937107441939503,1.5225968671783838,0.021278474306904327,119238905,1.0
33,JPM,1517464800000,116.87,116.985,115.48,115.77,13800613,1.2000000000000028,0.0,1.2000000000000028,77.09204890763121,110.84,117.3529,92.58548419290945,-7.414515807090553,1.7424735877693678,1.5665722112965808,0.034156269356694136,133039518,1.0
34,JPM,1517551200000,114.28,116.92,114.09,116.49,16477307,-2.5900000000000034,2.5900000000000034,0.0,49.311865842521236,111.07,117.3529,51.09105667764888,-48.90894332235112,1.5666788110222143,1.5665935312417076,-0.00043733053441785685,116562211,-1.0
35,JPM,1517810400000,108.8,114.59,103.98,113.0,30097591,-5.480000000000004,5.480000000000004,0.0,26.233347357986958,103.98,117.3529,36.04304227205761,-63.95695772794239,0.9990321780689584,1.453081260607158,-0.04736888188424826,86464620,-1.0
36,JPM,1517896800000,112.11,112.48,106.61,106.85,33114833,3.3100000000000023,0.0,3.3100000000000023,44.376417804063685,103.98,117.3529,60.79459204809723,-39.20540795190277,0.793438481785671,1.3211527048428606,-0.030777211031382423,119579453,1.0
37,JPM,1517983200000,112.87,114.45,111.146,111.55,21878324,0.7600000000000051,0.0,0.7600000000000051,47.779152807887634,103.98,117.3529,66.47772734410637,-33.52227265589364,0.6810789590626314,1.193137955686815,-0.02445980985306828,141457777,1.0
38,JPM,1518069600000,107.88,113.11,107.84,113.11,27425837,-4.990000000000009,4.990000000000009,0.0,32.64827142133048,103.98,117.3529,29.163457440046596,-70.83654255995341,0.20545757620902805,0.9956018797912576,-0.07255845942228334,114031940,-1.0
39,JPM,1518156000000,110.04,111.05,106.2299,109.1,28188027,2.160000000000011,0.0,2.160000000000011,41.84647356796742,103.98,117.3529,45.31552617607252,-54.68447382392748,-0.004169857828799195,0.7956475322672463,-0.053012048192771055,142219967,1.0
40,JPM,1518415200000,111.74,112.725,110.07,111.17,18043325,1.6999999999999886,0.0,1.6999999999999886,48.26298074377838,103.98,117.3529,58.027802496092775,-41.972197503907225,-0.03793313285257227,0.6289313992432826,-0.029276344366258367,160263292,1.0
41,JPM,1518501600000,112.43,113.05,110.8,111.32,16358181,0.6900000000000119,0.0,0.6900000000000119,50.80507142866674,103.98,117.3529,63.187491120101114,-36.812508879898886,-0.010892274696331583,0.5009666644553598,-0.028010720152156998,176621473,1.0
42,JPM,1518588000000,115.03,115.27,112.53,112.63,15186858,2.5999999999999943,0.0,2.5999999999999943,59.464633068755006,103.98,117.3529,82.62979608013218,-17.370203919867823,0.21081064543348305,0.4429354606509844,-0.015743989047659834,191808331,1.0
43,JPM,1518674400000,115.51,115.985,114.22,115.74,12130197,0.480000000000004,0.0,0.480000000000004,60.929637084247034,103.98,117.3529,86.21914468813794,-13.78085531186205,0.41908005101161905,0.4381643787231113,0.010763038151907711,203938528,1.0
44,JPM,1518760800000,114.68,116.07,114.5,114.55,13214253,-0.8299999999999983,0.8299999999999983,0.0,56.83156948458319,103.98,116.985,82.2760476739716,-17.7239523260284,0.513072915764127,0.4531460861313144,0.054044117647058965,190724275,-1.0
45,JPM,1519106400000,114.71,115.39,113.97,114.65,13461495,0.029999999999986926,0.0,0.029999999999986926,56.95232065246865,103.98,116.985,82.50672818146862,-17.493271818531383,0.5831334270928892,0.4791435543236294,0.023191508340023148,204185770,1.0
46,JPM,1519192800000,115.19,117.45,114.67,115.0,14212461,0.480000000000004,0.0,0.480000000000004,59.0661761067501,103.98,117.45,83.22197475872305,-16.77802524127695,0.6686650569542536,0.5170478548497542,0.02055462035970579,218398231,1.0
47,JPM,1519279200000,114.98,116.425,114.76,115.5,17070356,-0.20999999999999375,0.20999999999999375,0.0,57.63742661418062,103.98,117.45,81.66295471417968,-18.337045285820334,0.7116350664560542,0.5559652971710143,0.06581386725991845,201327875,-1.0
48,JPM,1519365600000,117.31,117.39,115.31,115.31,12162523,2.3299999999999983,0.0,2.3299999999999983,67.6540558483047,103.98,117.45,98.96065330363771,-1.039346696362291,0.9190516609243957,0.6285825699216906,0.06606688476917477,213490398,1.0
49,JPM,1519624800000,118.77,118.9,117.32,118.14,16511229,1.4599999999999937,0.0,1.4599999999999937,72.37646266768002,106.2299,118.9,98.9739623207393,-1.0260376792606973,1.1851607392465127,0.739898203786655,0.0629139072847682,230001627,1.0
50,JPM,1519711200000,117.36,119.33,117.35,118.91,17563345,-1.4099999999999966,1.4099999999999966,0.0,62.249211456735345,106.2299,119.33,84.96194685536751,-15.038053144632476,1.269623580361909,0.845843279101706,0.04384950635951257,212438282,-1.0
51,JPM,1519797600000,115.5,118.49,115.34,117.82,17735637,-1.8599999999999994,1.8599999999999994,0.0,51.31929900568031,106.2299,119.33,70.76358195738965,-29.236418042610353,1.175412876746691,0.911757198630703,0.004085890637224976,194702645,-1.0
52,JPM,1519884000000,113.43,116.6427,112.65,115.48,18690017,-2.069999999999993,2.069999999999993,0.0,41.877249266243936,106.2299,119.33,54.96217586125303,-45.03782413874697,0.9256566392229786,0.9145370867491582,-0.018007098952471656,176012628,-1.0
53,JPM,1519970400000,113.32,113.56,111.12,112.39,18353697,-0.11000000000001364,0.11000000000001364,0.0,41.41009316803108,110.07,119.33,35.097192224622006,-64.902807775378,0.7108020846236229,0.8737900863240511,-0.01185908615277309,157658931,-1.0
54,JPM,1520229600000,115.06,115.925,111.89,112.05,13933039,1.740000000000009,0.0,1.740000000000009,51.321314743216625,110.8,119.33,49.94138335287227,-50.05861664712773,0.671318485602967,0.8332957661798343,0.0030511725220121466,171591970,1.0
55,JPM,1520316000000,115.16,115.82,114.32,115.64,10674360,0.09999999999999432,0.0,0.09999999999999432,51.86131904856872,111.12,119.33,49.208282582216754,-50.79171741778325,0.6406018102370723,0.794756974991282,-0.0002604392742425743,182266330,1.0
56,JPM,1520402400000,114.73,115.1,113.11,113.75,13006514,-0.4299999999999926,0.4299999999999926,0.0,49.155806393363264,111.12,119.33,43.97076735688188,-56.02923264311812,0.575320724135878,0.7508697248202012,-0.0021742911810749277,169259816,-1.0
57,JPM,1520488800000,114.74,115.23,113.21,115.11,11173721,0.009999999999990905,0.0,0.009999999999990905,49.22688179109231,111.12,119.33,44.09257003654072,-55.90742996345928,0.5184041629129439,0.7043766124387498,-0.021907765748870545,180433537,1.0
58,JPM,1520575200000,118.04,118.08,115.67,116.55,15366583,3.3000000000000114,0.0,3.3000000000000114,66.86432433860364,111.12,119.33,84.28745432399522,-15.712545676004789,0.7285398363565321,0.7092092572223063,-0.006146333249136937,195800120,1.0
59,JPM,1520830800000,117.66,118.75,117.25,118.0,12339295,-0.38000000000000966,0.38000000000000966,0.0,63.914353390719896,111.12,119.33,79.6589524969549,-20.341047503045104,0.854804424211423,0.7383282906201297,0.002556237218813928,183460825,-1.0
60,JPM,1520917200000,116.25,118.47,115.83,118.2,13312340,-1.4099999999999966,1.4099999999999966,0.0,53.7597308059909,111.12,119.33,62.48477466504262,-37.51522533495738,0.8324401578114902,0.7571506640584019,0.006493506493506551,170148485,-1.0
61,JPM,1521003600000,114.95,116.59,114.6,116.56,12905124,-1.2999999999999972,1.2999999999999972,0.0,45.98701553274226,111.12,119.33,46.65042630937882,-53.34957369062118,0.7025340030980516,0.7462273318663319,0.01340033500837512,157243361,-1.0
62,JPM,1521090000000,115.24,116.0,114.83,115.87,8747977,0.28999999999999204,0.0,0.28999999999999204,47.92498800868147,111.12,119.33,50.18270401948834,-49.81729598051165,0.6157159779091188,0.7201250610748894,0.016943169784680467,165991338,1.0
63,JPM,1521176400000,115.44,116.6015,115.34,115.34,19888948,0.20000000000000284,0.0,0.20000000000000284,49.37053648404622,111.12,119.33,52.61875761266743,-47.38124238733256,0.5565250216442479,0.6874050531887611,0.003302624717538727,185880286,1.0
64,JPM,1521435600000,114.53,115.45,113.3,115.1,13214919,-0.9099999999999966,0.9099999999999966,0.0,43.09072778639467,111.12,118.75,44.69200524246394,-55.30799475753606,0.43166666322427716,0.6362573751958643,-0.005470649531087113,172665367,-1.0
65,JPM,1521522000000,114.64,115.445,114.445,114.87,9921175,0.10999999999999943,0.0,0.10999999999999943,44.08275488096051,111.12,118.75,46.13368283093051,-53.86631716906949,0.3376512686335218,0.5765361538833959,-0.0007844504488799808,182586542,1.0
66,JPM,1521608400000,114.74,116.63,114.21,114.81,13632983,0.09999999999999432,0.0,0.09999999999999432,45.086843699126426,111.12,118.75,47.44429882044551,-52.55570117955449,0.26808117596542047,0.5148451582998008,0.0,196219525,1.0
67,JPM,1521694800000,109.95,113.6,109.54,113.2,22550426,-4.789999999999992,4.789999999999992,0.0,22.628815949105515,109.54,118.75,4.451682953311583,-95.54831704668841,-0.16969266106217162,0.37793759442740626,-0.0685360894611996,173669099,-1.0
68,JPM,1521781200000,107.01,110.92,106.76,110.27,23081509,-2.9399999999999977,2.9399999999999977,0.0,16.727864854088793,106.76,118.75,2.085070892410343,-97.91492910758966,-0.7441743912403496,0.15351519729385507,-0.09051504334523197,150587590,-1.0
69,JPM,1522040400000,110.31,111.16,108.645,109.19,20217469,3.299999999999997,0.0,3.299999999999997,37.75134733404042,106.76,118.75,29.608006672226843,-70.39199332777315,-0.9236258831688957,-0.06191301879869515,-0.05109677419354841,170805059,1.0
70,JPM,1522126800000,108.17,111.69,107.3,111.07,18039921,-2.1400000000000006,2.1400000000000006,0.0,31.75293203256892,106.76,118.75,11.759799833194306,-88.24020016680569,-1.2237223095911105,-0.2942748769571783,-0.05898216615919971,152765138,-1.0
71,JPM,1522213200000,108.0,109.1699,106.65,108.28,19189269,-0.1700000000000017,0.1700000000000017,0.0,31.297114083615952,106.65,118.75,11.157024793388388,-88.84297520661161,-1.458387182051311,-0.5270973379760049,-0.06282540784449842,133575869,-1.0
72,JPM,1522299600000,109.97,110.78,107.78,108.5,13274639,1.9699999999999989,0.0,1.9699999999999989,42.36060565008265,106.65,118.75,27.438016528925573,-72.56198347107443,-1.4689835950572103,-0.7154745893922461,-0.04738392238392242,146850508,1.0
73,JPM,1522645200000,107.85,110.73,106.08,109.96,18822525,-2.1200000000000045,2.1200000000000045,0.0,35.30179463817207,106.08,118.47,14.285714285714251,-85.71428571428574,-1.6291247002430538,-0.8982046115624077,-0.058325329607962995,128027983,-1.0
74,JPM,1522731600000,109.33,109.5025,107.26,108.36,14050737,1.480000000000004,0.0,1.480000000000004,42.958378093007944,106.08,116.63,30.805687203791475,-69.19431279620852,-1.6182912260991316,-1.0422219344697525,-0.046318911374738314,142078720,1.0
75,JPM,1522818000000,110.99,111.21,107.02,107.1,15302608,1.6599999999999966,0.0,1.6599999999999966,50.53438676849247,106.08,116.63,46.54028436018955,-53.45971563981045,-1.4592867725584284,-1.1256349020874878,-0.03268258671779678,157381328,1.0
76,JPM,1522904400000,111.88,112.83,111.39,111.63,16627035,0.8900000000000006,0.0,0.8900000000000006,54.290070192923885,106.08,116.63,54.97630331753554,-45.02369668246446,-1.2472569475867346,-1.1499593111873372,0.017553433378808547,174008363,1.0
77,JPM,1522990800000,109.09,111.55,107.82,110.55,18906018,-2.789999999999992,2.789999999999992,0.0,42.59281367904734,106.08,116.63,28.53080568720385,-71.46919431279615,-1.2889757500436048,-1.1777625989585907,0.019437435753667964,155102345,-1.0
78,JPM,1523250000000,110.4,112.98,109.89,110.01,15974349,1.3100000000000023,0.0,1.3100000000000023,48.59344705346585,106.08,116.63,40.94786729857828,-59.05213270142172,-1.2026870368692926,-1.182747486540731,0.0008158825129180869,171076694,1.0
79,JPM,1523336400000,112.51,112.87,111.42,112.13,14003640,2.1099999999999994,0.0,2.1099999999999994,56.95541378554096,106.08,116.63,60.94786729857829,-39.05213270142172,-0.9533857488782616,-1.1368751390082372,0.04012203013774607,185080334,1.0
80,JPM,1523422800000,110.62,111.81,110.515,111.66,14503294,-1.8900000000000006,1.8900000000000006,0.0,48.75822245392977,106.08,113.6,60.37234042553203,-39.62765957446797,-0.8976953304567985,-1.0890391772979495,0.024259259259259203,170577040,-1.0
81,JPM,1523509200000,113.37,114.39,111.5,111.56,16435523,2.75,0.0,2.75,58.73019869497488,106.08,114.39,87.72563176895312,-12.27436823104688,-0.6248282845376707,-0.9961969987458937,0.03091752296080763,187012563,1.0
82,JPM,1523595600000,110.3,115.15,109.05,115.02,39152760,-3.0700000000000074,3.0700000000000074,0.0,46.958809587533686,106.08,115.15,46.52701212789411,-53.47298787210589,-0.6484431907998669,-0.9266462371566885,0.022716736207695876,147859803,-1.0
83,JPM,1523854800000,110.21,111.47,109.79,110.94,16580538,-0.09000000000000341,0.09000000000000341,0.0,46.64258119351303,106.08,115.15,45.53472987872097,-54.46527012127903,-0.6667222474743966,-0.8746614392202301,0.008049025884935501,131279265,-1.0
84,JPM,1523941200000,110.21,111.92,109.99,111.37,15501350,0.0,0.0,0.0,46.64258119351303,106.08,115.15,45.53472987872097,-54.46527012127903,-0.6734435699145536,-0.8344178653590947,-0.00702766014956302,131279265,0.0
85,JPM,1524027600000,109.32,111.07,108.89,110.53,16081436,-0.8900000000000006,0.8900000000000006,0.0,42.844034618474026,106.08,115.15,35.72216097023145,-64.27783902976856,-0.7419424494239024,-0.8159227821720563,-0.02288165892027172,115197829,-1.0
86,JPM,1524114000000,111.72,111.87,109.5,109.53,17910955,2.4000000000000057,0.0,2.4000000000000057,54.39920674091125,106.08,115.15,62.18302094818077,-37.816979051819224,-0.595918987321852,-0.7719220232020155,0.024108534237785362,133108784,1.0
87,JPM,1524200400000,111.47,112.74,110.88,112.3,15584384,-0.25,0.25,0.0,53.108708930374014,107.02,115.15,54.73554735547352,-45.26445264452648,-0.49464427617749607,-0.7164664737971117,0.00969202898550714,117524400,-1.0
88,JPM,1524459600000,110.93,111.95,110.63,111.57,11285831,-0.539999999999992,0.539999999999992,0.0,50.14397888220799,107.02,115.15,48.09348093480942,-51.90651906519058,-0.45269565209453333,-0.6637123094565961,-0.014043196160341331,106238569,-1.0
89,JPM,1524546000000,110.41,112.9,109.59,111.75,16453112,-0.5200000000000102,0.5200000000000102,0.0,47.215376832833996,107.82,115.15,35.33424283765347,-64.66575716234654,-0.4561142894228567,-0.6221927054498483,-0.001898390887723811,89785457,-1.0
90,JPM,1524632400000,109.99,110.53,108.6,110.27,13548246,-0.4200000000000017,0.4200000000000017,0.0,44.77812009137938,107.82,115.15,29.604365620736672,-70.39563437926333,-0.4870700755189574,-0.5951681794636702,-0.029813883743494807,76237211,-1.0
91,JPM,1524718800000,110.1,110.82,109.34,109.97,10299488,0.10999999999999943,0.0,0.10999999999999943,45.62631928319043,108.6,115.15,22.900763358778587,-77.09923664122141,-0.49700350518845937,-0.575535244608628,-0.0018132366273798661,86536699,1.0
92,JPM,1524805200000,109.4,110.1599,109.13,109.55,9383967,-0.6999999999999886,0.6999999999999886,0.0,41.00202719398558,108.6,115.15,12.213740458015419,-87.78625954198458,-0.5549215558158949,-0.5714125068500814,-0.007349605298974549,77152732,-1.0
93,JPM,1525064400000,108.78,110.3,108.75,109.75,13744860,-0.6200000000000045,0.6200000000000045,0.0,37.153688281688154,108.6,115.15,2.7480916030535347,-97.25190839694646,-0.6433995174089944,-0.585809908961864,-0.012975229108066366,63407872,-1.0
94,JPM,1525150800000,108.78,108.97,107.54,108.45,10503353,0.0,0.0,0.0,37.153688281688154,107.54,115.15,16.294349540078777,-83.70565045992122,-0.705386368261955,-0.6097252008218823,-0.004939626783754036,63407872,0.0
95,JPM,1525237200000,107.92,109.49,107.73,108.11,12162086,-0.8599999999999994,0.8599999999999994,0.0,31.66519943824362,107.54,115.15,4.993429697766038,-95.00657030223397,-0.8144764383469152,-0.650675448326889,-0.0340136054421768,51245786,-1.0
96,JPM,1525323600000,107.24,107.77,105.181,107.59,15379091,-0.6800000000000068,0.6800000000000068,0.0,27.90438674976751,105.181,112.9,26.674439694260855,-73.32556030573915,-0.9448788496488163,-0.7095161285912744,-0.03794742980174037,35866695,-1.0
97,JPM,1525410000000,108.43,108.74,105.98,106.43,11967906,1.190000000000012,0.0,1.190000000000012,41.849936114883725,105.181,112.9,42.09094442285278,-57.909055577147214,-0.9413945868209197,-0.7558918202372036,-0.022536734877850906,47834601,1.0
98,JPM,1525669200000,109.37,109.68,108.36,108.76,9356721,0.9399999999999977,0.0,0.9399999999999977,50.56533351259221,105.181,112.9,54.268687653841205,-45.731312346158795,-0.8529842663196092,-0.7753103094536848,-0.009419436645231372,57191322,1.0
99,JPM,1525755600000,110.99,111.34,109.28,109.53,12543228,1.6199999999999903,0.0,1.6199999999999903,61.915864278769504,105.181,112.9,75.25586215831055,-24.74413784168945,-0.6448198100801932,-0.7492122095789866,0.009091735612328344,69734550,1.0
100,JPM,1525842000000,113.41,113.64,111.03,111.44,11368094,2.4200000000000017,0.0,2.4200000000000017,72.71442598773675,105.181,113.64,97.28100248256291,-2.7189975174370953,-0.2814070258307453,-0.6556511728293384,0.030063578564941018,81102644,1.0
101,JPM,1525928400000,114.29,114.44,112.75,113.19,9159709,0.8800000000000097,0.0,0.8800000000000097,75.61545265651912,105.181,114.44,98.37995463872997,-1.6200453612700234,0.07669787175065323,-0.50918136391334,0.04469835466179162,90262353,1.0
102,JPM,1526014800000,113.86,114.73,113.67,114.49,10253045,-0.4300000000000068,0.4300000000000068,0.0,71.33904026535438,105.181,114.73,90.88909833490413,-9.110901665095863,0.3220985643499006,-0.34292537826069186,0.04669976098547535,80009308,-1.0
103,JPM,1526274000000,113.9,114.7,113.74,114.11,8710654,0.04000000000000625,0.0,0.04000000000000625,71.51197047826217,105.181,114.73,91.30799036548332,-8.69200963451668,0.5138823543494766,-0.17156383173865813,0.04706747563890423,88719962,1.0
104,JPM,1526360400000,113.03,113.91,112.57,113.91,11536212,-0.8700000000000045,0.8700000000000045,0.0,62.10755612383055,105.181,114.73,82.19708870038745,-17.802911299612543,0.5889014950340083,-0.019470766384124802,0.047349888806523355,77183750,-1.0
105,JPM,1526446800000,113.34,113.69,112.63,112.89,7571089,0.3100000000000023,0.0,0.3100000000000023,64.05124696892184,105.181,114.73,85.44350193737564,-14.556498062624353,0.665688317790881,0.1175610504508764,0.056881760537113024,84754839,1.0
106,JPM,1526533200000,112.96,113.41,112.2,113.2,8617204,-0.38000000000000966,0.38000000000000966,0.0,59.718593516548744,105.181,114.73,81.46402764687393,-18.535972353126077,0.687956321645288,0.2316401046897588,0.041778105690307044,76137635,-1.0
107,JPM,1526619600000,111.13,112.8,110.84,112.75,11806349,-1.8299999999999983,1.8299999999999983,0.0,43.404129383406406,105.181,114.73,62.29971724787929,-37.70028275212071,0.5516128532349711,0.29563465439880127,0.016092164213221016,64331286,-1.0
108,JPM,1526878800000,112.15,112.54,111.92,112.05,9441931,1.0200000000000102,0.0,1.0200000000000102,51.86178858557507,105.181,114.73,72.98146402764691,-27.018535972353092,0.5198552765323683,0.3404787788255147,0.010451392017299055,73773217,1.0
109,JPM,1526965200000,113.01,114.2852,112.29,112.35,11507550,0.8599999999999994,0.0,0.8599999999999994,57.97192763871525,105.181,114.73,81.98764268509794,-18.012357314902058,0.5576401557642328,0.38391105421325833,-0.0035270258354641593,85280767,1.0
110,JPM,1527051600000,112.49,112.77,111.12,112.51,11453916,-0.5200000000000102,0.5200000000000102,0.0,53.25584683001287,105.98,114.73,74.3999999999999,-25.600000000000104,0.5394145918773177,0.41501176174607024,-0.01574940939714775,73826851,-1.0
111,JPM,1527138000000,111.23,112.15,110.115,112.14,14084769,-1.259999999999991,1.259999999999991,0.0,43.38752171854601,108.36,114.73,45.054945054945094,-54.945054945054906,0.41849202261744267,0.4157078139203448,-0.023098542069207806,59742082,-1.0
112,JPM,1527224400000,110.66,111.08,110.195,110.46,8283548,-0.5700000000000074,0.5700000000000074,0.0,39.56106869207132,109.28,114.73,25.321100917431096,-74.6788990825689,0.27352002206284,0.38727025554884387,-0.02844600526777885,51458534,-1.0
113,JPM,1527570000000,105.93,109.2,104.955,109.18,30643840,-4.72999999999999,4.72999999999999,0.0,21.44889312521461,104.955,114.73,9.974424552429749,-90.02557544757025,-0.220446632344661,0.2657268779701429,-0.0628151818101389,20814694,-1.0
114,JPM,1527656400000,108.35,108.6,106.65,107.64,17490845,2.4199999999999875,0.0,2.4199999999999875,38.16209030609439,104.955,114.73,34.73145780051145,-65.26854219948855,-0.4119218633667572,0.13019712970276281,-0.044026821951649975,38305539,1.0
115,JPM,1527742800000,107.01,108.19,106.42,107.95,19808203,-1.3399999999999892,1.3399999999999892,0.0,33.59518872808418,104.955,114.73,21.023017902813358,-78.97698209718665,-0.6641248834224314,-0.028667272922276076,-0.05267351274787524,18497336,-1.0
116,JPM,1527829200000,108.4,108.94,107.8,108.34,13594185,1.3900000000000006,0.0,1.3900000000000006,41.91496522606528,104.955,114.7,35.351462288353055,-64.64853771164694,-0.7432804929384957,-0.17158991692552006,-0.024565823809952203,32091521,1.0
117,JPM,1528088400000,108.45,109.255,108.27,108.99,9415437,0.04999999999999716,0.0,0.04999999999999716,42.21545308967672,104.955,114.2852,37.45900409423166,-62.54099590576834,-0.792838149257264,-0.2958395633918689,-0.03299152920196169,41506958,1.0
118,JPM,1528174800000,107.84,108.31,107.07,108.24,10415231,-0.6099999999999994,0.6099999999999994,0.0,39.34986559643613,104.955,114.2852,30.92109493901528,-69.07890506098472,-0.8712861955141165,-0.4109288898163185,-0.045748163879302695,31091727,-1.0
119,JPM,1528261200000,110.36,110.74,108.48,108.66,15453563,2.519999999999996,0.0,2.519999999999996,54.176667904159935,104.955,114.2852,57.93016226876164,-42.069837731238366,-0.7218114994906557,-0.473105411751186,-0.018935016445906228,46545290,1.0
120,JPM,1528347600000,110.8,111.5,110.025,111.18,13444427,0.4399999999999977,0.0,0.4399999999999977,56.327581736450576,104.955,114.2852,62.64603116760622,-37.35396883239378,-0.5613791669443771,-0.49076016278982426,-0.0038658635260272467,59989717,1.0
121,JPM,1528434000000,111.11,111.14,110.06,110.62,10383168,0.3100000000000023,0.0,0.3100000000000023,57.93280991293462,104.955,114.2852,65.96857516451949,-34.03142483548051,-0.40455945796448134,-0.4735200218247558,0.004066510030724668,70372885,1.0
122,JPM,1528693200000,110.83,111.91,110.77,111.12,12642897,-0.28000000000000114,0.28000000000000114,0.0,55.7954741605488,104.955,114.2852,62.967567683436556,-37.03243231656345,-0.299419287038333,-0.43869987486747125,0.04625696214481256,57729988,-1.0
123,JPM,1528779600000,110.19,111.53,109.52,111.14,15294082,-0.6400000000000006,0.6400000000000006,0.0,50.84791334038316,104.955,112.77,66.9865642994242,-33.013435700575805,-0.264683090453417,-0.4038965179846604,0.016982002768804794,42435906,-1.0
124,JPM,1528866000000,109.97,111.445,109.58,110.46,14979749,-0.21999999999999886,0.21999999999999886,0.0,49.12031058986342,104.955,112.15,69.70118137595546,-30.29881862404454,-0.2520005574557871,-0.3735173258788858,0.027660966264835052,27456157,-1.0
125,JPM,1528952400000,108.03,110.36,107.78,110.28,20487343,-1.9399999999999977,1.9399999999999977,0.0,36.501715967390425,104.955,111.91,44.2127965492452,-55.787203450754795,-0.3939412815459491,-0.3776021170122985,-0.0034132841328413654,6968814,-1.0
126,JPM,1529038800000,107.9,108.38,106.27,107.8,26028572,-0.12999999999999545,0.12999999999999545,0.0,35.79081195636553,104.955,111.91,42.34363767074059,-57.656362329259416,-0.51102874922924,-0.40428744345568685,-0.005071461502996755,-19059758,-1.0
127,JPM,1529298000000,108.18,108.4,106.69,107.26,9786825,0.28000000000000114,0.0,0.28000000000000114,38.75516378033607,106.27,111.91,33.86524822695055,-66.13475177304946,-0.5746050608594686,-0.4383509669364432,0.003152818991097872,-9272933,1.0
128,JPM,1529384400000,107.55,107.88,106.6,106.9,12707154,-0.6300000000000097,0.6300000000000097,0.0,34.60724690249472,106.27,111.91,22.695035460992926,-77.30496453900707,-0.6681214110971609,-0.4843050557685868,-0.025462123957955773,-21980087,-1.0
129,JPM,1529470800000,107.54,108.64,107.44,108.18,8876903,-0.009999999999990905,0.009999999999990905,0.0,34.53954133360455,106.27,111.91,22.51773049645408,-77.48226950354592,-0.7345728828209275,-0.534358621179055,-0.02942238267148012,-30856990,-1.0
130,JPM,1529557200000,107.51,108.2061,106.53,107.1,11048735,-0.030000000000001137,0.030000000000001137,0.0,34.307207812240634,106.27,111.91,21.98581560283704,-78.01418439716296,-0.7806577907943364,-0.5836184551021113,-0.03240032400324,-41905725,-1.0
131,JPM,1529643600000,105.75,108.37,105.51,108.16,19938788,-1.7600000000000051,1.7600000000000051,0.0,23.573348387879378,105.51,111.91,3.749999999999925,-96.25000000000009,-0.9482615568272195,-0.656547075447133,-0.04583596499142828,-61844513,-1.0
132,JPM,1529902800000,104.79,105.7,103.96,105.66,16907607,-0.9599999999999937,0.9599999999999937,0.0,19.695103196103616,103.96,111.91,10.440251572327197,-89.5597484276728,-1.145347179812049,-0.7543070963201163,-0.04900626191124413,-78752120,-1.0
133,JPM,1529989200000,104.86,105.21,103.11,104.71,17086772,0.06999999999999318,0.0,0.06999999999999318,20.79148189710145,103.11,111.91,19.886363636363644,-80.11363636363636,-1.2811226020516813,-0.8596701974664295,-0.04646721833227241,-61665348,1.0
134,JPM,1530075600000,103.24,105.92,103.23,104.68,16276833,-1.6200000000000045,1.6200000000000045,0.0,15.236631123709515,103.11,111.91,1.477272727272676,-98.52272727272732,-1.5021266416170533,-0.9881614862965543,-0.0443395353142646,-77942181,-1.0
135,JPM,1530162000000,104.93,105.46,103.51,103.68,14491252,1.690000000000012,0.0,1.690000000000012,35.86272726095528,103.11,111.91,20.681818181818272,-79.31818181818173,-1.5233483179719087,-1.0951988526316254,-0.02752548656163112,-63450929,1.0
136,JPM,1530248400000,104.2,106.9,104.15,106.68,18972393,-0.730000000000004,0.730000000000004,0.0,31.983709860105023,103.11,111.53,12.945368171021416,-87.05463182897859,-1.5808470109137573,-1.192328484288052,-0.03679053429469403,-82423322,-1.0
137,JPM,1530507600000,105.08,105.09,103.38,103.72,11130044,0.8799999999999955,0.0,0.8799999999999955,40.87842650138223,103.11,111.445,23.63527294541092,-76.36472705458908,-1.537682574799959,-1.2613993023904335,-0.02296606229660625,-71293278,1.0
138,JPM,1530594000000,103.61,105.775,103.52,105.41,8311680,-1.4699999999999989,1.4699999999999989,0.0,32.64896883036339,103.11,110.36,6.896551724137931,-93.10344827586206,-1.603603281949006,-1.329840098302148,-0.03654454156592901,-79604958,-1.0
139,JPM,1530766800000,103.72,104.38,103.53,104.13,10723412,0.10999999999999943,0.0,0.10999999999999943,33.79966453665345,103.11,108.64,11.030741410488233,-88.96925858951177,-1.6282010490953525,-1.3895122884607891,-0.03525253464793976,-68881546,1.0
140,JPM,1530853200000,104.06,104.5,102.2,103.12,12173700,0.3400000000000034,0.0,0.3400000000000034,37.601757566431914,102.2,108.64,28.88198757763975,-71.11801242236024,-1.6017957281728457,-1.4319689764032006,-0.01598108747044913,-56707846,1.0
141,JPM,1531112400000,107.28,107.46,104.71,104.71,13900793,3.219999999999999,0.0,3.219999999999999,61.66257403897368,102.2,108.64,78.88198757763976,-21.11801242236025,-1.305991853465713,-1.4067735518157032,0.023761809332951467,-42807053,1.0
142,JPM,1531198800000,106.62,108.4,106.53,108.02,14575873,-0.6599999999999966,0.6599999999999966,0.0,56.50918403967792,102.2,108.64,68.63354037267085,-31.366459627329142,-1.1120023526643763,-1.347819311985438,0.016784283806980715,-57382926,-1.0
143,JPM,1531285200000,106.39,107.06,106.21,106.31,10186482,-0.23000000000000398,0.23000000000000398,0.0,54.67193670389605,102.2,108.4,67.58064516129025,-32.419354838709744,-0.9656912001618991,-1.2713936896207303,0.030511429678419244,-67569408,-1.0
144,JPM,1531371600000,106.85,107.56,105.97,107.42,12456754,0.45999999999999375,0.0,0.45999999999999375,57.83547912205463,102.2,108.4,74.99999999999983,-25.00000000000017,-0.8033602520221308,-1.1777870021010104,0.018297912894310375,-55112654,1.0
145,JPM,1531458000000,106.36,107.8,105.14,107.3,21303844,-0.4899999999999949,0.4899999999999949,0.0,53.26623216608448,102.2,108.4,67.0967741935483,-32.903225806451694,-0.7061106251558158,-1.0834517267119714,0.020729366602687094,-76416498,-1.0
146,JPM,1531717200000,110.58,110.77,106.98,107.05,24662621,4.219999999999999,0.0,4.219999999999999,73.81980823016409,102.2,110.77,97.78296382730458,-2.2170361726954244,-0.2852366892978182,-0.9238087192291408,0.05234107346783401,-51753877,1.0
147,JPM,1531803600000,110.5,110.93,109.7499,110.69,14821876,-0.0799999999999983,0.0799999999999983,0.0,73.11641701214074,102.2,110.93,95.0744558991981,-4.9255441008019085,0.0413766689240731,-0.730771641598498,0.06649937264742789,-66575753,-1.0
148,JPM,1531890000000,111.53,112.12,110.2,110.42,14244944,1.0300000000000011,0.0,1.0300000000000011,76.4499920246609,102.2,112.12,94.05241935483868,-5.947580645161324,0.3789632069595399,-0.5088246718868904,0.07529888160431941,-52330809,1.0
149,JPM,1531976400000,109.89,111.09,109.73,111.06,16775305,-1.6400000000000006,1.6400000000000006,0.0,62.26519928408875,102.2,112.12,77.52016129032255,-22.479838709677455,0.5083103445632275,-0.30539766859686673,0.05602536997885843,-69106114,-1.0
150,JPM,1532062800000,111.28,111.74,109.78,110.0,13582631,1.3900000000000006,0.0,1.3900000000000006,68.06068688521837,102.2,112.12,91.53225806451609,-8.467741935483904,0.7147402319996843,-0.10137008847755648,0.03728560775540646,-55523483,1.0
151,JPM,1532322000000,113.35,114.24,110.93,111.06,18140010,2.069999999999993,0.0,2.069999999999993,74.72970241181199,102.2,114.24,92.6079734219269,-7.392026578073099,1.0334547663888571,0.1255948824957263,0.06312136559744874,-37383473,1.0
152,JPM,1532408400000,114.15,114.78,113.42,113.55,14000419,0.8000000000000114,0.0,0.8000000000000114,76.88223415814592,102.2,114.78,94.99205087440386,-5.0079491255961495,1.3351997944945424,0.3675158648954896,0.07293918601372318,-23383054,1.0
153,JPM,1532494800000,115.18,115.52,113.38,113.88,13331966,1.0300000000000011,0.0,1.0300000000000011,79.4790004463221,102.2,115.52,97.44744744744753,-2.5525525525524726,1.6385584265137538,0.6217243772191425,0.07795975666822663,-10051088,1.0
154,JPM,1532581200000,114.85,115.585,114.581,115.42,11897769,-0.3300000000000125,0.3300000000000125,0.0,76.31020471422232,104.71,115.585,93.24137931034483,-6.758620689655167,1.8312348751886844,0.863626476813051,0.07982324182023315,-21948857,-1.0
155,JPM,1532667600000,116.03,116.3,114.81,115.18,12805930,1.1800000000000068,0.0,1.1800000000000068,79.65662726631004,105.14,116.3,97.58064516129036,-2.419354838709643,2.055453923044965,1.101991966059434,0.04928558509676262,-9142927,1.0
156,JPM,1532926800000,116.73,117.61,116.06,116.28,13411618,0.7000000000000028,0.0,0.7000000000000028,81.45021373924483,105.14,117.61,92.94306335204494,-7.056936647955056,2.2635402714001884,1.334301627127585,0.05638009049773762,4268691,1.0
157,JPM,1533013200000,114.95,117.08,114.82,117.08,15843763,-1.7800000000000011,1.7800000000000011,0.0,64.71062368376988,105.14,117.61,78.66880513231759,-21.331194867682413,2.258781913143693,1.5191976843308068,0.030664395229982988,-11575072,-1.0
158,JPM,1533099600000,115.66,116.69,115.28,115.75,13531590,0.7099999999999937,0.0,0.7099999999999937,67.76014660004097,105.14,117.61,84.36246992782675,-15.63753007217324,2.285950653210193,1.6725482781066843,0.052507052507052565,1956518,1.0
159,JPM,1533186000000,116.15,116.25,114.33,114.57,11058108,0.4900000000000091,0.0,0.4900000000000091,69.83584710000184,106.98,117.61,86.26528692380062,-13.734713076199382,2.3202741206929147,1.8020934466239302,0.04376347951114301,13014626,1.0
160,JPM,1533272400000,117.09,117.13,115.94,116.0,11016102,0.9399999999999977,0.0,0.9399999999999977,73.59839199408616,109.73,117.61,93.40101522842644,-6.598984771573557,2.395709303488573,1.9208166179968589,0.032995147772386435,24030728,1.0
161,JPM,1533531600000,117.12,117.53,116.18,116.79,9857351,0.030000000000001137,0.0,0.030000000000001137,73.71910996692743,109.73,117.61,93.78172588832493,-6.218274111675066,2.429902547078612,2.0226338038132097,0.026018396846254843,33888079,1.0
162,JPM,1533618000000,117.55,118.29,117.33,117.74,10562067,0.4299999999999926,0.0,0.4299999999999926,75.56675212791573,109.73,118.29,91.35514018691579,-8.644859813084215,2.463302792955915,2.1107676016417507,0.02057648897378006,44450146,1.0
163,JPM,1533704400000,117.79,118.2686,117.28,117.33,8997220,0.2400000000000091,0.0,0.2400000000000091,76.62507623948821,109.78,118.29,94.12455934195066,-5.87544065804935,2.480544475469131,2.184722976407227,0.025598606878537433,53447366,1.0
164,JPM,1533790800000,116.88,117.72,116.695,117.51,9694541,-0.9100000000000108,0.9100000000000108,0.0,64.4177370609666,110.93,118.29,80.84239130434769,-19.15760869565232,2.393192202865066,2.2264168216987947,0.007325691631474562,43752825,-1.0
165,JPM,1533877200000,115.73,115.95,114.6839,115.5,12630949,-1.1499999999999915,1.1499999999999915,0.0,52.27427625724672,113.38,118.29,47.86150712830964,-52.13849287169035,2.205743306957885,2.2222821187506128,-0.00856677803478112,31121876,-1.0
166,JPM,1534136400000,113.89,115.87799999999999,113.815,115.56,10340337,-1.8400000000000034,1.8400000000000034,0.0,38.778545255905726,113.38,118.29,10.38696537678216,-89.61303462321784,1.8869646854621749,2.155218632092925,-0.009221400608960484,20781539,-1.0
167,JPM,1534222800000,114.65,115.04,113.6499,114.27,10597611,0.7600000000000051,0.0,0.7600000000000051,45.48603244614502,113.6499,118.29,21.553414797094945,-78.44658520290506,1.676332127688994,2.059441331212139,-0.008732491786270002,31379150,1.0
168,JPM,1534309200000,113.7,114.33,112.97,113.82,10152082,-0.9500000000000028,0.9500000000000028,0.0,39.27911683220121,112.97,118.29,13.721804511278252,-86.27819548872175,1.41641979968432,1.9308370249065752,-0.02109341368919504,21227068,-1.0
169,JPM,1534395600000,114.77,115.31,114.3,114.35,10118820,1.0699999999999932,0.0,1.0699999999999932,48.425347923761166,112.97,118.29,33.83458646616531,-66.16541353383468,1.281999209269344,1.801069461779129,-0.019813818430267416,31345888,1.0
170,JPM,1534482000000,114.77,115.07,114.3,114.64,8505111,0.0,0.0,0.0,48.42534792376116,112.97,118.29,33.83458646616531,-66.16541353383468,1.1620742524770407,1.6732704199187114,-0.020064890710382532,31345888,0.0
171,JPM,1534741200000,114.62,115.05,114.11,114.59,8618739,-0.14999999999999147,0.14999999999999147,0.0,47.10119153804904,112.97,118.29,31.015037593985028,-68.98496240601497,1.042907147869343,1.5471977655088378,-0.024925563589961675,22727149,-1.0
172,JPM,1534827600000,115.32,116.385,114.88,115.37,10976680,0.6999999999999886,0.0,0.6999999999999886,53.890310449955024,112.97,118.29,44.172932330826896,-55.827067669173104,0.9934979946204976,1.43645781133117,-0.020969522030732768,33703829,1.0
173,JPM,1534914000000,114.97,115.41,114.78,115.31,8314901,-0.3499999999999943,0.3499999999999943,0.0,50.175177545685486,112.97,118.29,37.59398496240596,-62.406015037594045,0.91554501490333,1.332275252045602,-0.01634154688569467,25388928,-1.0
174,JPM,1535000400000,114.73,115.15,114.43,114.96,9265593,-0.23999999999999488,0.23999999999999488,0.0,47.5799312290233,112.97,118.29,33.08270676691734,-66.91729323308266,0.8248919064481299,1.2307985829261077,-0.00864080186641325,16123335,-1.0
175,JPM,1535086800000,114.68,115.22,114.45100000000001,114.98,8845718,-0.04999999999999716,0.04999999999999716,0.0,46.99560739411328,112.97,118.29,32.142857142857245,-67.85714285714275,0.7404783138373006,1.1327345291083464,0.006936517692510469,7277617,-1.0
176,JPM,1535346000000,116.71,117.28,115.17,115.22,13768021,2.029999999999987,0.0,2.029999999999987,66.35309115844947,112.97,118.2686,70.58468274638564,-29.415317253614358,0.8278409478306088,1.0717558128527989,0.0179677278674224,21045638,1.0
177,JPM,1535432400000,116.14,117.03,115.97,117.0,8302618,-0.5699999999999932,0.5699999999999932,0.0,59.33274961895956,112.97,117.72,66.7368421052632,-33.26315789473681,0.8413833304993403,1.0256813163821072,0.021459982409850475,12743020,-1.0
178,JPM,1535518800000,115.76,116.37,115.36,116.35,7221744,-0.37999999999999545,0.37999999999999545,0.0,54.867279802281224,112.97,117.28,64.73317865429246,-35.26682134570754,0.8120916826723743,0.9829633896401606,0.008625947547268531,5521276,-1.0
179,JPM,1535605200000,115.19,116.04,114.98,115.59,8991802,-0.5700000000000074,0.5700000000000074,0.0,48.54393548059947,112.97,117.28,51.50812064965192,-48.491879350348086,0.7344177339885221,0.933254258509833,0.0036594928988411546,-3470526,-1.0
180,JPM,1535691600000,114.58,114.84,113.819,114.83,13065719,-0.6099999999999994,0.6099999999999994,0.0,42.49627805119893,112.97,117.28,37.35498839907189,-62.6450116009281,0.6165317144872802,0.8699097497053225,-0.0003489792357355137,-16536245,-1.0
181,JPM,1536037200000,115.15,115.24,113.63,114.34,10174177,0.5700000000000074,0.0,0.5700000000000074,49.30561723563291,112.97,117.28,50.58004640371243,-49.41995359628757,0.5626149212015719,0.8084507840045724,-0.001474158862296071,-6362068,1.0
182,JPM,1536123600000,114.59,115.7,114.25,115.0,11462446,-0.5600000000000023,0.5600000000000023,0.0,43.47032065601253,113.63,117.28,26.301369863013875,-73.69863013698613,0.46928851998065113,0.7406183311997883,-0.003305210054796892,-17824514,-1.0
183,JPM,1536210000000,114.1,114.7,113.5,114.5,9877635,-0.4900000000000091,0.4900000000000091,0.0,38.830554562114884,113.5,117.28,15.873015873015717,-84.12698412698428,0.3517332340063888,0.6628413117611084,-0.005491153142159977,-27702149,-1.0
184,JPM,1536296400000,114.32,114.77,113.63,114.5,10955590,0.21999999999999886,0.0,0.21999999999999886,42.035634298688855,113.5,117.28,21.693121693121505,-78.30687830687849,0.27317300548322976,0.5849076505055327,-0.0031391698639694487,-16746559,1.0
185,JPM,1536555600000,113.71,114.97,113.66,114.85,8276936,-0.6099999999999994,0.6099999999999994,0.0,36.000726716206614,113.5,117.28,5.555555555555388,-94.44444444444461,0.1598489451398848,0.49989590943240314,-0.025704738240082237,-25023495,-1.0
186,JPM,1536642000000,114.43,114.575,113.18,113.54,9333781,0.7200000000000131,0.0,0.7200000000000131,46.467667226774594,113.18,117.28,30.487804878048824,-69.51219512195118,0.1266765156858014,0.42525203068308276,-0.014723609436886442,-15689714,1.0
187,JPM,1536728400000,113.08,114.88,112.85,114.25,10800758,-1.3500000000000085,1.3500000000000085,0.0,34.323133989599086,112.85,117.28,5.191873589164867,-94.80812641083514,-0.008449142089475004,0.3385117961285712,-0.023151347615756768,-26490472,-1.0
188,JPM,1536814800000,113.52,114.13,112.67,113.37,12470769,0.4399999999999977,0.0,0.4399999999999977,40.20064278577616,112.67,117.28,18.43817787418643,-81.56182212581356,-0.07912083614307619,0.25498526967424173,-0.014497786266168933,-14019703,1.0
189,JPM,1536901200000,113.5,114.49,113.23,113.81,10337948,-0.01999999999999602,0.01999999999999602,0.0,40.01283851926111,112.67,117.28,18.00433839479389,-81.99566160520611,-0.13518417563523144,0.17695138061234708,-0.009425728748472695,-24357651,-1.0
190,JPM,1537160400000,113.84,114.43,113.3,113.79,9561297,0.3400000000000034,0.0,0.3400000000000034,45.04841831652286,112.67,117.03,26.834862385321145,-73.16513761467886,-0.15044538702747445,0.11147202708438277,-0.011376465479808973,-14796354,1.0
191,JPM,1537246800000,114.3,114.655,113.56,114.33,7944210,0.45999999999999375,0.0,0.45999999999999375,51.41517994644455,112.67,116.37,44.0540540540539,-55.94594594594611,-0.12399255541846799,0.0643791105838126,-0.002530761846583518,-6852144,1.0
192,JPM,1537333200000,117.62,118.06,114.44,114.44,16052776,3.3200000000000074,0.0,3.3200000000000074,75.27320191632732,112.67,118.06,91.8367346938776,-8.163265306122405,0.1629888358559839,0.08410105563824687,0.030850131463628472,9200632,1.0
193,JPM,1537419600000,118.63,119.24,118.08,118.5,15589976,1.009999999999991,0.0,1.009999999999991,78.90873185630187,112.67,119.24,90.71537290715372,-9.284627092846272,0.4665441586465704,0.1605896762399116,0.03770118964310698,24790608,1.0
194,JPM,1537506000000,117.85,119.23,117.74,119.13,24788247,-0.7800000000000011,0.7800000000000011,0.0,69.76806916686759,112.67,119.24,78.84322678843225,-21.15677321156776,0.6368334546519918,0.2558384319223277,0.036408407352035876,2361,-1.0
195,JPM,1537765200000,116.72,118.46,116.4315,117.76,12492474,-1.1299999999999955,1.1299999999999955,0.0,58.450075579322245,112.67,119.24,61.64383561643838,-38.35616438356163,0.6728512055785671,0.3392409866535756,0.020012234553875574,-12490113,-1.0
196,JPM,1537851600000,116.39,117.97,116.32,117.04,9308310,-0.3299999999999983,0.3299999999999983,0.0,55.42060059569685,112.67,119.24,56.62100456621009,-43.37899543378991,0.6670776408457044,0.4048083174920014,0.029271312345242384,-21798423,-1.0
197,JPM,1537938000000,115.02,116.8699,114.66,116.75,14023640,-1.3700000000000045,1.3700000000000045,0.0,44.39767135334661,112.67,119.24,35.7686453576864,-64.2313546423136,0.545664443205581,0.4329795426347174,0.013213530655391104,-35822063,-1.0
198,JPM,1538024400000,114.52,115.76,114.16,115.42,13282987,-0.5,0.5,0.0,40.966430091498985,112.67,119.24,28.158295281582895,-71.8417047184171,0.4044357132742675,0.42727077676262737,0.008986784140969206,-49105050,-1.0
199,JPM,1538110800000,112.84,114.24,112.52,113.65,15815120,-1.6799999999999926,1.6799999999999926,0.0,31.521727978579136,112.52,119.24,4.761904761904873,-95.23809523809513,0.1551604012775556,0.372848701665613,-0.008784258608573459,-64920170,-1.0
200,JPM,1538370000000,113.5,114.61,113.04,113.37,10147110,0.6599999999999966,0.0,0.6599999999999966,38.00101588999607,112.52,119.24,14.583333333333396,-85.4166666666666,0.010740584904823436,0.3004270783134551,-0.006999125109361293,-54773060,1.0
201,JPM,1538456400000,113.97,114.12,112.8128,113.36,13753074,0.46999999999999886,0.0,0.46999999999999886,42.4734566213432,112.52,119.24,21.577380952381,-78.42261904761901,-0.06503837214108898,0.22733398822254627,-0.031032137391600156,-41019986,1.0
202,JPM,1538542800000,115.04,115.66,114.48,114.94,17141962,1.0700000000000074,0.0,1.0700000000000074,51.637774143249814,112.52,119.24,37.50000000000016,-62.499999999999844,-0.03831205936349136,0.17420477870533874,-0.030262159656073373,-23878024,1.0
203,JPM,1538629200000,115.27,116.81,114.21,114.55,16357406,0.22999999999998977,0.0,0.22999999999998977,53.47600810431949,112.52,119.24,40.92261904761905,-59.07738095238094,0.0014115398756473496,0.13964613093940045,-0.021892235893084422,-7520618,1.0
204,JPM,1538715600000,114.62,116.1,114.015,115.83,13777633,-0.6499999999999915,0.6499999999999915,0.0,47.57886085998956,112.52,119.24,31.250000000000135,-68.74999999999987,-0.019333913145814563,0.10785012212235745,-0.01799177518848527,-21298251,-1.0
205,JPM,1538974800000,115.32,115.78,113.3534,114.25,14370869,0.6999999999999886,0.0,0.6999999999999886,53.896431711970166,112.52,119.24,41.66666666666663,-58.33333333333337,0.02047330540700898,0.09037475877928776,-0.009193229658905455,-6927382,1.0
206,JPM,1539061200000,114.52,115.03,113.67,114.67,14069477,-0.7999999999999972,0.7999999999999972,0.0,46.50566667964459,112.52,119.24,29.761904761904766,-70.23809523809523,-0.012389673592934969,0.06982187230484321,-0.004347070074769643,-20996859,-1.0
207,JPM,1539147600000,111.47,114.95,111.47,114.7,23086389,-3.049999999999997,3.049999999999997,0.0,29.007377027444804,111.47,119.23,0.0,-100.0,-0.28130064699379886,-0.00040263155488522455,-0.026632902549772908,-44083248,-1.0
208,JPM,1539234000000,108.13,111.47,107.38,110.97,33705616,-3.3400000000000034,3.3400000000000034,0.0,19.66032071767509,107.38,118.46,6.768953068592058,-93.23104693140795,-0.7552188977332435,-0.15136588479055693,-0.04174051754696928,-77788864,-1.0
209,JPM,1539320400000,106.95,110.83,105.6,110.37,32075740,-1.1799999999999926,1.1799999999999926,0.0,17.37766103497404,105.6,117.97,10.913500404203784,-89.08649959579623,-1.2120469325786871,-0.3635020943481831,-0.057709251101321524,-109864604,-1.0
210,JPM,1539579600000,106.34,108.85,106.32,107.2,18903216,-0.6099999999999994,0.6099999999999994,0.0,16.252132139058816,105.6,116.8699,6.566162965066315,-93.43383703493369,-1.6048090985232193,-0.6117634951831905,-0.06694744230937966,-128767820,-1.0
211,JPM,1539666000000,108.62,108.78,106.73,107.16,19302764,2.280000000000001,0.0,2.280000000000001,34.53773469902028,105.6,116.81,26.940231935771703,-73.0597680642283,-1.7123599928775946,-0.8318827947220714,-0.05580667593880395,-109465056,1.0
212,JPM,1539752400000,109.83,110.8,108.23,108.38,18794482,1.2099999999999937,0.0,1.2099999999999937,42.25789877955405,105.6,116.81,37.734165923282795,-62.265834076717205,-1.680585230086848,-1.0016232817950268,-0.04719354558861799,-90670574,1.0
213,JPM,1539838800000,108.09,109.84,107.81,109.02,17582467,-1.7399999999999949,1.7399999999999949,0.0,35.34213611472228,105.6,116.81,22.21231043710979,-77.78768956289022,-1.7753419140327509,-1.1563670082425717,-0.056970860233816145,-108253041,-1.0
214,JPM,1539925200000,107.91,109.22,107.27,107.65,15234549,-0.18000000000000682,0.18000000000000682,0.0,34.664971595846495,105.6,116.81,20.606601248884928,-79.39339875111507,-1.8437086377748955,-1.2938353341490365,-0.0642559833506764,-123487590,-1.0
215,JPM,1540184400000,106.36,108.34,106.1132,108.15,16199139,-1.5499999999999972,1.5499999999999972,0.0,29.121066627836825,105.6,116.81,6.779661016949193,-93.22033898305081,-1.9999081020653193,-1.4350498877322933,-0.07125392944463849,-139686729,-1.0
216,JPM,1540270800000,105.25,106.16,103.7,104.2,21407548,-1.1099999999999994,1.1099999999999994,0.0,25.72193659199101,103.7,116.81,11.823035850495783,-88.17696414950422,-2.18804262788575,-1.5856484357629848,-0.055799766753386604,-161094277,-1.0
217,JPM,1540357200000,103.29,105.03,102.9068,104.76,23168916,-1.9599999999999937,1.9599999999999937,0.0,20.780093079652275,102.9068,116.1,2.9045265742958684,-97.09547342570413,-2.4668597827367478,-1.7618907051577377,-0.04476093591047803,-184263193,-1.0
218,JPM,1540443600000,104.86,105.9,103.72,104.18,17464708,1.5699999999999932,0.0,1.5699999999999932,32.72611534203142,102.9068,115.78,15.172606655687753,-84.82739334431226,-2.531951749379772,-1.9159029140021444,-0.019541841982234742,-166798485,1.0
219,JPM,1540530000000,103.42,104.56,102.73,104.0,19174916,-1.4399999999999977,1.4399999999999977,0.0,28.222196557499046,102.73,115.03,5.609756097560958,-94.39024390243904,-2.6689673678746573,-2.066515804776647,-0.027459093473763407,-185973401,-1.0
220,JPM,1540789200000,104.85,106.63,103.7,104.46,18445175,1.4299999999999926,0.0,1.4299999999999926,37.999376399383706,102.73,114.95,17.348608837970463,-82.65139116202954,-2.631826134415533,-2.179577870704424,-0.03470815687718665,-167528226,1.0
221,JPM,1540875600000,106.7,106.98,104.86,105.71,18019681,1.8500000000000085,0.0,1.8500000000000085,48.47590513846362,102.73,111.47,45.42334096109841,-54.57665903890159,-2.425156214283305,-2.2286935394202003,-0.028498588728034235,-149508545,1.0
222,JPM,1540962000000,109.02,110.48,107.79,108.08,20859992,2.319999999999993,0.0,2.319999999999993,58.59868232876149,102.73,110.83,77.65432098765427,-22.345679012345723,-2.050527009730885,-2.1930602334823375,0.00860394116014418,-128648553,1.0
223,JPM,1541048400000,108.98,110.22,108.32,109.62,13065023,-0.03999999999999204,0.03999999999999204,0.0,58.37054153806986,102.73,110.8,77.44733581164814,-22.552664188351855,-1.7368371541054302,-2.101815617606956,0.009915670466129178,-141713576,-1.0
224,JPM,1541134800000,108.38,110.81,107.49,109.9,19009493,-0.6000000000000085,0.6000000000000085,0.0,54.68562673225605,102.73,110.81,69.92574257425733,-30.07425742574267,-1.5191389792211822,-1.9852802899298012,0.018992102294095536,-160723069,-1.0
225,JPM,1541397600000,109.09,109.29,108.42,108.61,10276448,0.710000000000008,0.0,0.710000000000008,58.28159941598242,102.73,110.81,78.71287128712872,-21.28712871287128,-1.274627430788911,-1.8431497181016232,0.03648456057007121,-150446621,1.0
226,JPM,1541484000000,109.6,109.67,107.76,108.67,10824959,0.5099999999999909,0.0,0.5099999999999909,60.85616251400755,102.73,110.81,85.02475247524742,-14.975247524752577,-1.0278491253818345,-1.6800895995576655,0.061090134572562516,-139621662,1.0
227,JPM,1541570400000,111.48,111.73,109.35,110.37,12679585,1.8800000000000097,0.0,1.8800000000000097,68.99471543325737,102.73,111.73,97.22222222222221,-2.7777777777777777,-0.6728194122399458,-1.4786355620941216,0.06313179477398445,-126942077,1.0
228,JPM,1541656800000,112.38,112.925,111.0,111.01,11662499,0.8999999999999915,0.0,0.8999999999999915,72.18873189894191,102.73,112.925,94.6542422756253,-5.345757724374714,-0.3151999016223499,-1.2459484299997674,0.08663701411719194,-115279578,1.0
229,JPM,1541743200000,111.29,112.36,110.83,112.23,10432161,-1.0899999999999892,1.0899999999999892,0.0,63.10440049127983,102.73,112.925,83.962726826876,-16.037273173124003,-0.11837321903603026,-1.02043338780702,0.061421077730090756,-125711739,-1.0
230,JPM,1542002400000,108.95,111.94,108.6,111.42,13279671,-2.3400000000000034,2.3400000000000034,0.0,48.10823441865102,102.73,112.925,61.010299166257994,-38.989700833742006,-0.1494819605369173,-0.8462431023529994,0.02108716026241808,-138991410,-1.0
231,JPM,1542088800000,109.59,111.12,109.1,109.1,13746059,0.6400000000000006,0.0,0.6400000000000006,51.728368041312606,102.73,112.925,67.28788621873471,-32.71211378126529,-0.12109727780232049,-0.7012139374428635,0.005228398458998473,-125245351,1.0
232,JPM,1542175200000,107.33,110.71,105.9836,110.23,18361433,-2.260000000000005,2.260000000000005,0.0,40.279006378570095,102.73,112.925,45.120156939676285,-54.87984306032372,-0.2777634378569047,-0.6165238375256719,-0.015140392732611585,-143606784,-1.0
233,JPM,1542261600000,110.07,110.08,106.81,108.24,19099954,2.739999999999995,0.0,2.739999999999995,54.39856291040833,103.7,112.925,69.05149051490508,-30.94850948509491,-0.1787666895051956,-0.5289724079215766,0.015593282893522797,-124506830,1.0
234,JPM,1542348000000,109.99,110.76,108.55,109.45,13798551,-0.0799999999999983,0.0799999999999983,0.0,53.96870653516337,104.86,112.925,63.60818350898943,-36.39181649101057,-0.1055496736057222,-0.44428786105840573,0.008250068750572881,-138305381,-1.0
235,JPM,1542607200000,110.83,111.2,109.5282,109.96,13986991,0.8400000000000034,0.0,0.8400000000000034,57.990507604137704,105.9836,112.925,69.81876854813153,-30.181231451868474,0.020025476769788497,-0.35142519349276685,0.011222627737226265,-124318390,1.0
236,JPM,1542693600000,108.45,110.49,107.98,109.78,18936153,-2.3799999999999955,2.3799999999999955,0.0,45.10647365755522,105.9836,112.925,35.531737113550676,-64.46826288644932,-0.07167519222582541,-0.2954751932393786,-0.027179763186221728,-143254543,-1.0
237,JPM,1542780000000,107.64,109.61,107.64,109.03,10619625,-0.8100000000000023,0.8100000000000023,0.0,41.486865624194834,105.9836,112.925,23.862621373210082,-76.13737862678992,-0.20731901834365374,-0.2778439582602336,-0.04217832354511475,-153874168,-1.0
238,JPM,1542952800000,106.65,107.39,106.06,106.74,6488406,-0.9899999999999949,0.9899999999999949,0.0,37.2692115651123,105.9836,112.925,9.600368801682801,-90.3996311983172,-0.39020441959335983,-0.3003160505268589,-0.041692874472099906,-160362574,-1.0
239,JPM,1543212000000,109.26,109.98,107.45,107.72,13948285,2.6099999999999994,0.0,2.6099999999999994,52.086570658139536,105.9836,112.925,47.20085285389127,-52.79914714610873,-0.3208388022223545,-0.304420600865958,0.0028453418999541125,-146414289,1.0
240,JPM,1543298400000,109.72,110.03,108.63,108.76,9238176,0.45999999999999375,0.0,0.45999999999999375,54.282593612388375,105.9836,112.925,53.827758089146315,-46.172241910853685,-0.22614108176581738,-0.2887646970459299,0.0011862396204032066,-137176113,1.0
241,JPM,1543384800000,110.94,111.4,108.87,109.8,13977257,1.2199999999999989,0.0,1.2199999999999989,59.90610721207987,105.9836,112.925,71.40346327830123,-28.59653672169878,-0.05204866811206443,-0.2414214912591568,0.03363458492499771,-123198856,1.0
242,JPM,1543471200000,110.06,110.795,109.635,110.27,11144347,-0.8799999999999955,0.8799999999999955,0.0,54.342731643519784,105.9836,112.36,63.92948999435425,-36.07051000564575,0.014742239568462878,-0.19018874509363287,-9.085127646035751e-05,-134343203,-1.0
243,JPM,1543557600000,111.19,111.32,109.58,109.85,18652718,1.1299999999999955,0.0,1.1299999999999955,59.86518686307977,105.9836,111.94,87.40850177959842,-12.591498220401581,0.1570457451149565,-0.120741847051915,0.010910082734794102,-115690485,1.0
244,JPM,1543816800000,112.24,112.89,111.74,112.38,16033180,1.0499999999999972,0.0,1.0499999999999972,64.47248083190769,105.9836,112.89,90.58843970809676,-9.411560291903239,0.35050808375999054,-0.02649186088953387,0.012722187133447527,-99657305,1.0
245,JPM,1543903200000,107.23,111.6,106.73,111.6,23555940,-5.009999999999991,5.009999999999991,0.0,39.50505803218292,105.9836,112.89,18.047028842812573,-81.95297115718742,0.09842862953793485,-0.001507762804040117,-0.011249423697556438,-123213245,-1.0
246,JPM,1544076000000,105.19,105.36,102.88,105.01,27213946,-2.0400000000000063,2.0400000000000063,0.0,33.42377541744784,102.88,112.89,23.076923076923087,-76.92307692307692,-0.2629262540247197,-0.05379146104817606,-0.022761055369751038,-150427191,-1.0
247,JPM,1544162400000,103.29,106.9817,102.91,105.16,19248595,-1.8999999999999915,1.8999999999999915,0.0,28.679354657256397,102.88,112.89,4.095904095904201,-95.9040959040958,-0.6946096947732627,-0.18195510779319343,-0.03150492264416316,-169675786,-1.0
248,JPM,1544421600000,101.36,103.49,99.28,102.87,23636429,-1.9300000000000068,1.9300000000000068,0.0,24.588521854956483,99.28,112.89,15.28288023512122,-84.71711976487877,-1.1788675499844317,-0.38133759623144114,-0.07230459454512173,-193312215,-1.0
249,JPM,1544508000000,100.37,103.66,100.21,103.13,16860677,-0.9899999999999949,0.9899999999999949,0.0,22.67426030756235,99.28,112.89,8.008817046289519,-91.99118295371048,-1.6238118230883316,-0.6298324416028194,-0.08521691578563606,-210172892,-1.0
250,JPM,1544594400000,101.02,102.9,100.0603,101.66,22621487,0.6499999999999915,0.0,0.6499999999999915,26.980833136077635,99.28,112.89,12.78471711976484,-87.21528288023515,-1.902058056336486,-0.8842775645495529,-0.08941770326302512,-187551405,1.0
251,JPM,1544680800000,101.12,101.97,100.67,101.55,17250942,0.10000000000000853,0.0,0.10000000000000853,27.695669394081676,99.28,112.89,13.519470977222655,-86.48052902277735,-2.0904041586722997,-1.1255028833741023,-0.0812284208613483,-170300463,1.0
252,JPM,1544767200000,100.29,101.94,99.86,99.99,19879525,-0.8299999999999983,0.8299999999999983,0.0,25.321632819852553,99.28,112.89,7.421013960323329,-92.57898603967666,-2.2803573251268716,-1.3564737717246562,-0.0980303984171238,-190179988,-1.0
253,JPM,1545026400000,99.01,100.56,98.435,99.77,25113534,-1.2800000000000011,1.2800000000000011,0.0,21.970475746829194,98.435,112.89,3.9778623313732475,-96.02213766862675,-2.5053023147570315,-1.5862394803311315,-0.11787241625089084,-215293522,-1.0
254,JPM,1545112800000,98.54,100.89,98.12,99.42,20837150,-0.46999999999999886,0.46999999999999886,0.0,20.803974556493444,98.12,112.89,2.8436018957346096,-97.15639810426539,-2.6904836903861735,-1.8070883223421403,-0.08104075352047002,-236130672,-1.0
255,JPM,1545199200000,97.29,100.58,96.6,98.41,28767868,-1.25,1.25,0.0,17.889247689612816,96.6,112.89,4.235727440147401,-95.7642725598526,-2.904623130386156,-2.026595283950944,-0.07510219602623813,-264898540,-1.0
256,JPM,1545285600000,96.45,98.28,95.69,96.61,31825218,-0.8400000000000034,0.8400000000000034,0.0,16.136286408209102,95.69,112.89,4.41860465116282,-95.58139534883719,-3.106303624448671,-2.2425369520504894,-0.06622131861748481,-296723758,-1.0
257,JPM,1545372000000,94.17,98.43,93.685,96.68,41313933,-2.280000000000001,2.280000000000001,0.0,12.347081915218965,93.685,112.89,2.525384014579534,-97.47461598542047,-3.4107962775033798,-2.4761888171410678,-0.07093528018942385,-338037691,-1.0
258,JPM,1545631200000,92.14,94.22,92.14,92.89,17009280,-2.030000000000001,2.030000000000001,0.0,9.9473579280628,92.14,111.6,0.0,-100.0,-3.772426745756661,-2.735436402864187,-0.08199661253362567,-355046971,-1.0
259,JPM,1545804000000,95.96,95.96,91.11,92.69,22542900,3.819999999999993,0.0,3.819999999999993,36.671829940520375,91.11,106.9817,30.557533219503853,-69.44246678049615,-3.7080354978427152,-2.929956221859893,-0.0500890912690557,-332504071,1.0
260,JPM,1545890400000,97.04,97.15,93.55,94.82,20304683,1.0800000000000125,0.0,1.0800000000000125,42.26150348897059,91.11,106.9817,37.36209731786768,-62.63790268213232,-3.5291758536305196,-3.0498001482140187,-0.04034810126582278,-312199388,1.0
261,JPM,1545976800000,96.83,98.32,96.44,97.95,17963271,-0.21000000000000796,0.21000000000000796,0.0,41.4408466898917,91.11,103.66,45.57768924302789,-54.42231075697212,-3.365577262219901,-3.1129555710151955,-0.03449995014458074,-330162659,-1.0
262,JPM,1546236000000,97.62,98.8085,96.77,97.59,13237180,0.7900000000000063,0.0,0.7900000000000063,45.9930532206139,91.11,103.66,51.87250996015942,-48.12749003984059,-3.136027627872494,-3.1175699823866556,-0.01403898596101405,-316925479,1.0
263,JPM,1546408800000,99.31,99.78,95.94,95.95,15670850,1.6899999999999977,0.0,1.6899999999999977,54.68768072341284,91.11,102.9,69.55046649703137,-30.449533502968627,-2.785628027038271,-3.051181591316979,0.007814085650497127,-301254629,1.0
264,JPM,1546495200000,97.11,98.89,96.69,98.64,16286426,-2.200000000000003,2.200000000000003,0.0,44.03846922486387,91.11,101.97,55.24861878453039,-44.75138121546961,-2.6548519517740345,-2.9719156634083905,-0.0018501387604070718,-317541055,-1.0
265,JPM,1546581600000,100.69,100.93,98.28,99.11,16935205,3.5799999999999983,0.0,3.5799999999999983,59.02131267874363,91.11,101.94,88.45798707294551,-11.542012927054481,-2.2365532954020892,-2.8248431898071305,0.04396060134784863,-300605850,1.0
266,JPM,1546840800000,100.76,101.47,99.7103,100.43,15430712,0.07000000000000739,0.0,0.07000000000000739,59.267355209944135,91.11,101.47,93.14671814671821,-6.853281853281794,-1.8777545954542774,-2.63542547093656,0.069979823723054,-285175138,1.0
267,JPM,1546927200000,100.57,101.82,99.545,101.63,13578777,-0.19000000000001194,0.19000000000001194,0.0,58.17344816724347,91.11,101.82,88.32866479925303,-11.671335200746972,-1.590402285275232,-2.4264208338042947,0.09149120902973729,-298753915,-1.0
268,JPM,1547013600000,100.4,101.49,99.93,100.81,14230331,-0.1699999999999875,0.1699999999999875,0.0,57.08568262617111,91.11,101.82,86.74136321195157,-13.258636788048445,-1.3607057199052832,-2.2132778110244926,0.046269278866194474,-312984246,-1.0
269,JPM,1547100000000,100.39,100.73,99.27,100.02,14376430,-0.010000000000005116,0.010000000000005116,0.0,57.013324744674605,91.11,101.82,86.64799253034553,-13.352007469654467,-1.1660351262965776,-2.0038292740789094,0.03452184666117053,-327360676,-1.0
270,JPM,1547186400000,99.91,100.17,98.95,99.89,15439850,-0.480000000000004,0.480000000000004,0.0,53.273437495175656,91.11,101.82,82.16619981325866,-17.833800186741342,-1.038517879121187,-1.8107669950873648,0.03180832386657029,-342800526,-1.0
271,JPM,1547445600000,100.94,101.36,98.66,98.87,21258458,1.0300000000000011,0.0,1.0300000000000011,59.80216702207785,91.11,101.82,91.78338001867418,-8.216619981325826,-0.8446110002944636,-1.6175357961287846,0.03400942429829956,-321542068,1.0
272,JPM,1547532000000,101.68,102.47,98.6,98.89,26504852,0.7400000000000091,0.0,0.7400000000000091,63.97482979553944,91.11,102.47,93.04577464788738,-6.954225352112606,-0.6240331209098855,-1.418835261085005,0.023864666196757645,-295037216,1.0
273,JPM,1547618400000,102.5,103.45,101.8,102.25,18532952,0.8199999999999932,0.0,0.8199999999999932,68.19591047070604,93.55,103.45,90.40404040404037,-9.595959595959618,-0.3786911001140538,-1.210806428890815,0.05550406755226023,-276504264,1.0
274,JPM,1547704800000,102.92,103.5,101.9208,102.11,14247564,0.4200000000000017,0.0,0.4200000000000017,70.25561955022886,95.94,103.5,92.32804232804234,-7.671957671957647,-0.14865172657586356,-0.9983754884278246,0.02214718442745056,-262256700,1.0
275,JPM,1547791200000,104.59,104.9,102.83,103.77,16428710,1.6700000000000017,0.0,1.6700000000000017,77.06898013932815,95.94,104.9,96.54017857142854,-3.459821428571451,0.16649196175190184,-0.7654019983918794,0.038011115522032624,-245827990,1.0
276,JPM,1548136800000,102.94,103.59,102.13,103.08,17083681,-1.6500000000000057,1.6500000000000057,0.0,61.110612580362755,95.94,104.9,78.12499999999993,-21.87500000000007,0.27987813402012307,-0.5563459719094789,0.023565675648801854,-262911671,-1.0
277,JPM,1548223200000,102.68,103.7,101.965,103.44,12146678,-0.2599999999999909,0.2599999999999909,0.0,58.89337315775337,96.69,104.9,72.95980511571258,-27.040194884287416,0.34478321903678477,-0.3761201337202261,0.02270916334661366,-275058349,-1.0
278,JPM,1548309600000,102.74,103.09,101.94,102.13,11296764,0.05999999999998806,0.0,0.05999999999998806,59.28670402187694,98.28,104.9,67.37160120845907,-32.628398791540924,0.39649195266214576,-0.22159771644375173,0.02340870604641898,-263761585,1.0
279,JPM,1548396000000,103.39,104.31,102.74,103.51,14412559,0.6500000000000057,0.0,0.6500000000000057,63.63607947042447,98.6,104.9,76.031746031746,-23.968253968254004,0.48433791827109474,-0.08041058950078239,0.03483134821339218,-249349026,1.0
280,JPM,1548655200000,103.88,104.24,102.59,102.89,12283089,0.4899999999999949,0.0,0.4899999999999949,66.72781663891939,98.6,104.9,83.80952380952368,-16.190476190476325,0.5867319036385652,0.05301790912708717,0.029126213592232997,-237065937,1.0
281,JPM,1548741600000,104.17,105.11,103.7301,103.88,9743271,0.29000000000000625,0.0,0.29000000000000625,68.55361343443415,98.6,105.11,85.56067588325658,-14.439324116743427,0.6834026112123581,0.1790948495441414,0.02448859166011008,-227322666,1.0
282,JPM,1548828000000,104.41,105.24,103.78,104.14,12526274,0.23999999999999488,0.0,0.23999999999999488,70.11936245892232,98.6,105.24,87.50000000000003,-12.499999999999973,0.770499004760822,0.2973756805874776,0.01863414634146343,-214796392,1.0
283,JPM,1548914400000,103.5,103.8,102.73,103.41,17520551,-0.9099999999999966,0.9099999999999966,0.0,57.57702030609829,98.6,105.24,73.79518072289164,-26.204819277108353,0.7573637119236736,0.38937328685471684,0.005635445005829798,-232316943,-1.0
284,JPM,1549000800000,103.88,104.8455,103.52,104.0,13000780,0.37999999999999545,0.0,0.37999999999999545,60.9431297718033,98.6,105.24,79.51807228915663,-20.481927710843365,0.768754992889555,0.4652496280616845,-0.0067884118940626514,-219316163,1.0
285,JPM,1549260000000,104.25,104.25,103.01,103.79,9871549,0.37000000000000455,0.0,0.37000000000000455,64.13985387151777,98.6,105.24,85.09036144578322,-14.909638554216789,0.7984347145171,0.5318866453527676,0.01272585972411111,-209444614,1.0
286,JPM,1549346400000,103.79,104.55,103.29,104.52,12762982,-0.45999999999999375,0.45999999999999375,0.0,57.40037299531684,101.8,105.24,57.84883720930263,-42.15116279069737,0.775893929880084,0.580688102258231,0.010810284378652169,-222207596,-1.0
287,JPM,1549432800000,103.74,104.62,103.465,103.71,8744957,-0.05000000000001137,0.05000000000001137,0.0,56.653773994657854,101.9208,105.24,54.80838756326819,-45.19161243673181,0.7454030709214408,0.613631095990873,0.009733307377846945,-230952553,-1.0
288,JPM,1549519200000,102.38,103.5,101.44,103.25,13177489,-1.3599999999999994,1.3599999999999994,0.0,40.230897636318865,101.44,105.24,24.736842105263115,-75.26315789473689,0.6045295709509588,0.6118107909828902,-0.009768836444530415,-244130042,-1.0
289,JPM,1549605600000,101.36,102.335,100.06,102.08,12892562,-1.019999999999996,1.019999999999996,0.0,32.162618024237815,100.06,105.24,25.09652509652508,-74.90347490347492,0.40590184795870243,0.5706290023780526,-0.02425876010781669,-257022604,-1.0
290,JPM,1549864800000,100.88,102.01,100.771,101.76,10978516,-0.480000000000004,0.480000000000004,0.0,29.004190345986515,100.06,105.24,15.830115830115721,-84.16988416988428,0.20736557669864908,0.4979763172421719,-0.031582989344341006,-268001120,-1.0
291,JPM,1549951200000,102.6,102.92,101.89,101.95,12852252,1.7199999999999989,0.0,1.7199999999999989,49.506075170210465,100.06,105.24,49.034749034748955,-50.96525096525105,0.18666205273568437,0.43571346434087443,-0.017335504262043888,-255148868,1.0
292,JPM,1550037600000,103.09,103.85,102.9,102.9,10754061,0.4900000000000091,0.0,0.4900000000000091,53.883631228509614,100.06,105.24,58.4942084942086,-41.5057915057914,0.20740245928038803,0.39005126332877715,-0.003961352657004813,-244394807,1.0
293,JPM,1550124000000,102.42,103.1,101.35,102.47,11518530,-0.6700000000000017,0.6700000000000017,0.0,47.40027246220189,100.06,105.24,45.55984555984561,-54.44015444015439,0.16784121131807694,0.34560925292663713,-0.014054678475163618,-255913337,-1.0
294,JPM,1550210400000,105.55,105.7,103.66,103.9,14716861,3.1299999999999955,0.0,3.1299999999999955,68.09383453439348,100.06,105.7,97.3404255319148,-2.659574468085207,0.3846198208732545,0.35341136651596067,0.012470023980815315,-241196476,1.0
295,JPM,1550556000000,105.18,105.37,103.81,104.91,12764888,-0.36999999999999034,0.36999999999999034,0.0,64.62595481865863,100.06,105.7,90.7801418439717,-9.219858156028298,0.5205618104609755,0.38684145530496367,0.013392427016090114,-253961364,-1.0
296,JPM,1550642400000,105.69,105.8,104.875,105.21,10030326,0.5099999999999909,0.0,0.5099999999999909,67.276483795135,100.06,105.8,98.08362369337979,-1.9163763066202009,0.6618204996151604,0.44183726416700303,0.018796992481203034,-243931038,1.0
297,JPM,1550728800000,105.47,105.99,104.96,105.45,8400075,-0.21999999999999886,0.21999999999999886,0.0,64.85763162244018,100.06,105.99,91.23102866779095,-8.76897133220905,0.7474012902689253,0.5029500693873875,0.030181676108615108,-252331113,-1.0
298,JPM,1550815200000,105.0,106.09,104.775,105.7,10647258,-0.46999999999999886,0.46999999999999886,0.0,59.57742569865116,100.06,106.09,81.9237147595356,-18.076285240464397,0.7684414961659911,0.5560483547431082,0.035911602209944826,-262978371,-1.0
299,JPM,1551074400000,106.1,107.27,105.69,105.75,11230679,1.0999999999999943,0.0,1.0999999999999943,66.86275115089222,100.06,107.27,83.77253814147014,-16.227461858529857,0.863918107659714,0.6176223053264294,0.051744647105471886,-251747692,1.0
300,JPM,1551160800000,105.29,105.47,103.94,104.5,15465393,-0.8099999999999881,0.8099999999999881,0.0,57.983618500541816,100.06,107.27,72.53814147018043,-27.461858529819576,0.8642611154428721,0.666950067349718,0.026218323586744807,-267213085,-1.0
301,JPM,1551247200000,105.16,105.38,104.505,105.18,9968822,-0.13000000000000966,0.13000000000000966,0.0,56.591914334681434,100.06,107.27,70.73509015256586,-29.264909847434133,0.8443103538440795,0.7024221246485903,0.020079542147637852,-277181907,-1.0
302,JPM,1551333600000,104.36,105.21,104.18,105.01,15156850,-0.7999999999999972,0.7999999999999972,0.0,48.351547707444695,100.06,107.27,59.63938973647712,-40.36061026352287,0.7552399810420525,0.7129856959272828,0.018941612966217436,-292338757,-1.0
303,JPM,1551420000000,104.43,105.905,104.2,105.1,13813310,0.07000000000000739,0.0,0.07000000000000739,49.099833182062795,100.771,107.27,56.30096937990473,-43.699030620095265,0.6824328230794521,0.7068751213577167,-0.010611084793936465,-278525447,1.0
304,JPM,1551679200000,104.19,105.9155,103.2668,104.92,12466285,-0.2400000000000091,0.2400000000000091,0.0,46.438209929327925,101.35,107.27,47.97297297297302,-52.02702702702698,0.5984678665790284,0.6851936704019791,-0.00941243582430129,-290991732,-1.0
305,JPM,1551765600000,104.11,104.55,103.26,104.13,10856646,-0.0799999999999983,0.0799999999999983,0.0,45.489776141908244,101.35,107.27,46.62162162162169,-53.37837837837831,0.5194814434912587,0.652051225019835,-0.014949380263033385,-301848378,-1.0
306,JPM,1551852000000,103.72,104.57,103.55,103.86,9070782,-0.39000000000000057,0.39000000000000057,0.0,40.8023034099085,101.35,107.27,40.033783783783846,-59.966216216216154,0.42056636621903465,0.605754253259675,-0.016592395941974036,-310919160,-1.0
307,JPM,1551938400000,102.97,103.47,102.16,103.25,12705739,-0.75,0.75,0.0,33.209077378446196,102.16,107.27,15.851272015655624,-84.14872798434438,0.2784469596271748,0.540292794533175,-0.019333333333333313,-323624899,-1.0
308,JPM,1552024800000,103.01,103.23,101.99,101.99,10582371,0.04000000000000625,0.0,0.04000000000000625,33.96531863798806,101.99,107.27,19.31818181818201,-80.68181818181799,0.16711754466618345,0.4656577445597767,-0.0291234684260131,-313042528,1.0
309,JPM,1552280400000,104.35,104.545,103.66,103.98,9763235,1.3399999999999892,0.0,1.3399999999999892,54.06790362128447,101.99,107.27,44.696969696969674,-55.30303030303032,0.18488375750254704,0.40950294714833074,-0.00892772343052528,-303279293,1.0
310,JPM,1552366800000,104.04,104.79,103.7544,104.59,10219100,-0.30999999999998806,0.30999999999998806,0.0,50.004467566211716,101.99,107.27,38.82575757575778,-61.17424242424222,0.17196687288802082,0.3619957322962688,-0.010650437428679993,-313498393,-1.0
311,JPM,1552453200000,104.39,104.98,103.95,104.19,13022241,0.3499999999999943,0.0,0.3499999999999943,54.46281898910179,101.99,107.27,45.45454545454555,-54.545454545454454,0.18780729807068042,0.3271580454511511,0.00028746646224608874,-300476152,1.0
312,JPM,1552539600000,105.34,105.87,104.46,104.5,10926470,0.9500000000000028,0.0,0.9500000000000028,64.40417507727929,101.99,107.27,63.446969696969845,-36.553030303030155,0.27386110927324125,0.31649865821556916,0.00871397108110683,-289549682,1.0
313,JPM,1552626000000,106.55,106.8,105.23,105.41,24811730,1.2099999999999937,0.0,1.2099999999999937,73.05062540518654,101.99,106.8,94.8024948024948,-5.197505197505195,0.4346854786253118,0.3401360222975177,0.02265092619253295,-264737952,1.0
314,JPM,1552885200000,107.19,107.785,106.5,106.55,12935514,0.6400000000000006,0.0,0.6400000000000006,76.52995256081604,101.99,107.785,89.73252804141504,-10.267471958584965,0.606787927790009,0.393466403396016,0.02958409374699844,-251802438,1.0
315,JPM,1552971600000,106.8,108.4,106.55,108.2,12889267,-0.39000000000000057,0.39000000000000057,0.0,70.16090761223722,101.99,108.4,75.03900156006232,-24.960998439937686,0.7035999557369763,0.45549311386420815,0.029695333590435746,-264691705,-1.0
316,JPM,1553058000000,104.52,106.65,104.41,106.43,14920658,-2.280000000000001,2.280000000000001,0.0,44.935038626955624,101.99,108.4,39.46957878315128,-60.530421216848715,0.589551260192664,0.48230474312989935,0.015052928037292412,-279612363,-1.0
317,JPM,1553144400000,102.87,103.49,102.2804,103.49,19751044,-1.6499999999999915,1.6499999999999915,0.0,34.5594129006879,101.99,108.4,13.728549141965807,-86.2714508580342,0.3618544045959453,0.4582146754231086,-0.001359091350354391,-299363407,-1.0
318,JPM,1553230800000,99.76,102.32,99.52,101.82,31113709,-3.1099999999999994,3.1099999999999994,0.0,23.00627714210104,99.52,108.4,2.702702702702802,-97.2972972972972,-0.06875543274223617,0.35282065379003963,-0.043986583612841246,-330477116,-1.0
319,JPM,1553490000000,98.93,100.57,98.09,99.59,21032295,-0.8299999999999983,0.8299999999999983,0.0,20.858979765272423,98.09,108.4,8.147429679922437,-91.85257032007756,-0.4715551009376071,0.18794550284451025,-0.04911572472126102,-351509411,-1.0
320,JPM,1553576400000,99.92,100.4,98.82,99.82,15987129,0.9899999999999949,0.0,0.9899999999999949,29.867807299185827,98.09,108.4,17.74975751697379,-82.2502424830262,-0.702790680283556,0.00979826621889697,-0.042820193505125004,-335522282,1.0
321,JPM,1553662800000,99.58,100.4499,99.08,99.88,12753234,-0.3400000000000034,0.3400000000000034,0.0,28.578666884790934,98.09,108.4,14.45198836081469,-85.5480116391853,-0.9030716534995662,-0.17277571772479575,-0.054680083539016544,-348275516,-1.0
322,JPM,1553749200000,100.71,100.8,99.74,100.0,12454070,1.1299999999999955,0.0,1.1299999999999955,38.7213629851367,98.09,108.4,25.412221144519787,-74.58777885548021,-0.9595530809094157,-0.33013119036171984,-0.054809948381041806,-335821446,1.0
323,JPM,1553835600000,101.23,101.99,100.585,101.54,14523395,0.5200000000000102,0.0,0.5200000000000102,43.01806707256415,98.09,108.4,30.45586808923375,-69.54413191076625,-0.9513883521751154,-0.454382622724399,-0.05560220169791952,-321298051,1.0
324,JPM,1554094800000,104.64,104.68,102.12,102.15,17499280,3.4099999999999966,0.0,3.4099999999999966,62.77025924300461,98.09,108.4,63.53055286129967,-36.46944713870033,-0.6621266604103795,-0.4959314302615951,-0.020224719101123556,-303798771,1.0
325,JPM,1554181200000,105.14,105.44,104.33,104.6,10295539,0.5,0.0,0.5,64.83269641567331,98.09,108.4,68.380213385063,-31.619786614936995,-0.3880654869722804,-0.4743582416037322,0.005931879066207513,-293503232,1.0
326,JPM,1554267600000,105.35,106.36,104.785,105.81,11499209,0.20999999999999375,0.0,0.20999999999999375,65.75213230038904,98.09,108.4,70.41707080504355,-29.58292919495646,-0.1521706589286964,-0.409920725068725,0.024108097598911193,-282004023,1.0
327,JPM,1554354000000,105.56,105.73,104.45,104.55,11952078,0.21000000000000796,0.0,0.21000000000000796,66.75502909505951,98.09,108.4,72.45392822502423,-27.54607177497578,0.05113350160586094,-0.3177098797338078,0.05813953488372081,-270051945,1.0
328,JPM,1554440400000,105.31,106.11,104.99,105.8,9933660,-0.25,0.25,0.0,64.17367125887472,98.09,108.4,70.02909796314255,-29.970902036857446,0.18989165015470633,-0.21618957375610498,0.06449004346507636,-279985605,-1.0
329,JPM,1554699600000,105.65,105.65,104.91,105.11,8056282,0.3400000000000034,0.0,0.3400000000000034,66.22326908441764,98.09,106.65,88.3177570093458,-11.682242990654203,0.32356379901571586,-0.10823889920174079,0.05734587670136104,-271929323,1.0
330,JPM,1554786000000,104.87,105.2,104.25,105.08,9092188,-0.7800000000000011,0.7800000000000011,0.0,57.513620285634566,98.09,106.36,81.98307134220077,-18.016928657799223,0.362383131610855,-0.014114493039221604,0.05312311709178563,-281021511,-1.0
331,JPM,1554872400000,105.34,105.715,104.47,105.13,10882304,0.46999999999999886,0.0,0.46999999999999886,61.073133692283804,98.09,106.36,87.66626360338577,-12.333736396614228,0.4261602938248785,0.07394046433359845,0.04597358752854741,-270139207,1.0
332,JPM,1554958800000,106.23,106.73,105.56,105.71,11183845,0.8900000000000006,0.0,0.8900000000000006,67.09630989765063,98.09,106.73,94.21296296296296,-5.787037037037036,0.5422687793900707,0.1676061273448929,0.049392472587177716,-258955362,1.0
333,JPM,1555045200000,111.21,111.85,108.88,109.44,25834073,4.97999999999999,0.0,4.97999999999999,83.53988474819792,98.82,111.85,95.08825786646202,-4.911742133537993,1.0243222221592276,0.33894934630775997,0.06278669724770625,-233121289,1.0
334,JPM,1555304400000,109.94,111.0,109.12,110.92,15163815,-1.269999999999996,1.269999999999996,0.0,72.83001223395887,99.08,111.85,85.04306969459672,-14.956930305403269,1.2890156918830797,0.528962615422824,0.045653414494958966,-248285104,-1.0
335,JPM,1555390800000,111.1,111.39,109.86,109.9,11583232,1.1599999999999966,0.0,1.1599999999999966,76.06403810154646,99.74,111.85,93.80677126341867,-6.1932287365813385,1.574242590476672,0.7380186104335936,0.05457997152349314,-236701872,1.0
336,JPM,1555477200000,114.3,114.66,111.01,111.7,17791890,3.200000000000003,0.0,3.200000000000003,82.6409266297268,100.585,114.66,97.44227353463589,-2.5577264653641163,2.0350415270887936,0.9974231937646337,0.08279651383099651,-218909982,1.0
337,JPM,1555563600000,113.46,114.945,113.33,114.53,12501949,-0.8400000000000034,0.8400000000000034,0.0,76.29165581351228,102.12,114.945,88.42105263157895,-11.578947368421058,2.3058664315334596,1.259111841318399,0.07739056120026588,-231411931,-1.0
338,JPM,1555909200000,113.6,113.93,112.6622,112.83,7975860,0.14000000000000057,0.0,0.14000000000000057,76.63684471610823,104.25,114.945,87.42402992052362,-12.57597007947639,2.502941596764586,1.5078777924076365,0.07524846190250822,-223436071,1.0
339,JPM,1555995600000,113.74,114.37,112.85,113.0,9193318,0.14000000000000057,0.0,0.14000000000000057,77.02285561042768,104.25,114.945,88.7330528284245,-11.266947171575493,2.6399897564553925,1.734300185217188,0.08458090969772081,-214242753,1.0
340,JPM,1556082000000,113.55,114.15,112.81,113.26,9245743,-0.18999999999999773,0.18999999999999773,0.0,75.08032582368139,104.25,114.945,86.95652173913047,-13.043478260869538,2.7021216222364757,1.9278644726210459,0.0779381051832162,-223488496,-1.0
341,JPM,1556168400000,113.61,114.145,112.5,113.01,9311768,0.060000000000002274,0.0,0.060000000000002274,75.30724084572151,104.25,114.945,87.5175315568023,-12.482468443197705,2.7247933504440027,2.0872502481856374,0.06947190059305286,-214176728,1.0
342,JPM,1556254800000,114.47,114.58,113.6,113.95,7889519,0.8599999999999994,0.0,0.8599999999999994,78.53917438335887,104.25,114.945,95.5586722767649,-4.441327723235107,2.7801083129944573,2.2258218611474017,0.029313910619548578,-206287209,1.0
343,JPM,1556514000000,116.12,117.155,114.445,114.6,14242237,1.6500000000000057,0.0,1.6500000000000057,83.36050007959479,104.25,117.155,91.97985277024412,-8.020147229755882,2.923388032223116,2.3653350953625445,0.05621247953429154,-192044972,1.0
344,JPM,1556600400000,116.05,116.72399999999999,115.26,116.43,11389147,-0.07000000000000739,0.07000000000000739,0.0,82.45373996910624,104.47,117.155,91.2889239258967,-8.711076074103302,2.9967452135877295,2.4916171190075818,0.044554455445544594,-203434119,-1.0
345,JPM,1556686800000,115.16,117.0,115.11,115.72,10412881,-0.8900000000000006,0.8900000000000006,0.0,71.10670207192612,105.56,117.155,82.79430789133244,-17.20569210866757,2.949070695128981,2.583107834231862,0.007524059492563406,-213847000,-1.0
346,JPM,1556773200000,115.41,115.7753,114.58,115.17,8613305,0.25,0.0,0.25,72.34041934781673,108.88,117.155,78.9123867069486,-21.087613293051398,2.898054241121315,2.6460971156097526,0.017186673717609846,-205233695,1.0
347,JPM,1556859600000,116.12,116.68,115.67,116.0,8185409,0.710000000000008,0.0,0.710000000000008,75.73554134105188,109.12,117.155,87.1188550093342,-12.881144990665799,2.881696002327473,2.693216892953297,0.022183098591549433,-197048286,1.0
348,JPM,1557118800000,115.09,115.47,113.72,114.18,9387010,-1.0300000000000011,1.0300000000000011,0.0,62.82685876934159,109.86,117.155,71.69294037011656,-28.307059629883447,2.753874635724742,2.7053484415075864,0.011869175312115399,-206435296,-1.0
349,JPM,1557205200000,113.21,114.03,112.285,114.03,15017725,-1.8800000000000097,1.8800000000000097,0.0,46.23144214212374,111.01,117.155,35.80146460537006,-64.19853539462994,2.4723749936775903,2.6587537519415876,-0.0029942756494936162,-221453021,-1.0
350,JPM,1557291600000,112.61,113.67,112.46,112.66,9576075,-0.5999999999999943,0.5999999999999943,0.0,42.13310581647548,112.285,117.155,6.673511293634549,-93.32648870636545,2.1757883796101964,2.5621606774753096,-0.008802042073761118,-231029096,-1.0
351,JPM,1557378000000,112.52,112.74,110.58,111.14,12205866,-0.09000000000000341,0.09000000000000341,0.0,41.49642754309671,110.58,117.155,29.505703422053188,-70.49429657794681,1.911445153436489,2.4320175726675455,-0.017035031012492374,-243234962,-1.0
352,JPM,1557464400000,112.51,112.84,110.54,111.75,13189381,-0.009999999999990905,0.009999999999990905,0.0,41.41619101869936,110.54,117.155,29.780801209372644,-70.21919879062736,1.6817580656544067,2.281965671264918,-0.03108852910781945,-256424343,-1.0
353,JPM,1557723600000,109.45,110.45,108.98,110.08,13783652,-3.0600000000000023,3.0600000000000023,0.0,24.612919087532234,108.98,117.155,5.749235474006104,-94.25076452599389,1.2385358964162805,2.0732797162951906,-0.056872037914691864,-270207995,-1.0
354,JPM,1557810000000,110.32,111.72,109.5,109.55,10503672,0.8699999999999903,0.0,0.8699999999999903,33.4681345747733,108.98,117.155,16.391437308868376,-83.60856269113162,0.9465694003303042,1.8479376531022134,-0.0420284821118444,-259704323,1.0
355,JPM,1557896400000,109.9,110.8958,108.61,109.21,10142048,-0.4199999999999875,0.4199999999999875,0.0,31.41278102128895,108.61,117.155,15.096547688706915,-84.90345231129308,0.6735293318831452,1.6130559888583997,-0.04774282991075285,-269846371,-1.0
356,JPM,1557982800000,111.31,112.17,110.59,110.62,9672729,1.4099999999999966,0.0,1.4099999999999966,44.593362134087805,108.61,117.155,31.597425394967843,-68.40257460503216,0.5644121348730664,1.4033272180613332,-0.04142266620737167,-260173642,1.0
357,JPM,1558069200000,110.77,111.75,109.8257,110.0,9570477,-0.5400000000000063,0.5400000000000063,0.0,41.102874429667075,108.61,117.0,25.74493444576873,-74.25506555423127,0.4294124832569679,1.2085442711004601,-0.037535841515335844,-269744119,-1.0
358,JPM,1558328400000,111.35,111.81,110.37,110.58,8518244,0.5799999999999983,0.0,0.5799999999999983,46.3110208122197,108.61,117.0,32.65792610250291,-67.34207389749707,0.36501774215305716,1.0398389653109796,-0.01642964402437952,-261225875,1.0
359,JPM,1558414800000,111.73,111.92,111.215,111.44,7967976,0.38000000000000966,0.0,0.38000000000000966,49.675167543529604,108.61,116.68,38.66171003717474,-61.33828996282526,0.34071966587899283,0.9000151054245822,-0.00781458129828605,-253257899,1.0
360,JPM,1558501200000,110.82,111.79,110.75,111.4,7918898,-0.9100000000000108,0.9100000000000108,0.0,42.34379535460987,108.61,116.68,27.385377942998655,-72.61462205700134,0.24520727374547846,0.7690535390887614,-0.015108425168858908,-261176797,-1.0
361,JPM,1558587600000,108.64,109.79,107.5,109.64,14557969,-2.1799999999999926,2.1799999999999926,0.0,30.074746203989235,107.5,115.47,14.303638644918454,-85.69636135508155,-0.006321891301979576,0.6139784530106133,-0.034396942494000604,-275734766,-1.0
362,JPM,1558674000000,109.71,109.96,109.19,109.52,8537252,1.0699999999999932,0.0,1.0699999999999932,39.93167924183006,107.5,114.03,33.8437978560489,-66.15620214395109,-0.11796073125313455,0.4675906161578637,0.0023755139333028197,-267197514,1.0
363,JPM,1559019600000,108.52,109.83,108.44,109.2,11665579,-1.1899999999999977,1.1899999999999977,0.0,33.81485055137925,107.5,113.67,16.531604538087453,-83.46839546191255,-0.2990115519412768,0.31427018253803557,-0.01631617113850614,-278863093,-1.0
364,JPM,1559106000000,108.22,108.4,107.06,107.45,9966365,-0.29999999999999716,0.29999999999999716,0.0,32.37238439463002,107.06,112.84,20.069204152249075,-79.93079584775093,-0.46138457040699166,0.1591392319490301,-0.015286624203821764,-288829458,-1.0
365,JPM,1559192400000,107.06,109.18,106.54,108.65,10367822,-1.1599999999999966,1.1599999999999966,0.0,27.196387352148918,106.54,112.84,8.253968253968194,-91.7460317460318,-0.6758775669780022,-0.007864127836376402,-0.038181654837840306,-299197280,-1.0
366,JPM,1559278800000,105.96,106.589,104.84,105.56,10952857,-1.1000000000000085,1.1000000000000085,0.0,23.1469418848899,104.84,112.17,15.27967257844462,-84.72032742155538,-0.9239746148101773,-0.19108622523113666,-0.04342330956035034,-310150137,-1.0
367,JPM,1559538000000,106.46,106.86,105.3,105.8,11680745,0.5,0.0,0.5,28.71385796199837,104.84,112.17,22.100954979536024,-77.89904502046397,-1.067936978612508,-0.366456375907411,-0.04391558149977548,-298469392,1.0
368,JPM,1559624400000,109.74,109.9,107.13,107.85,12858587,3.280000000000001,0.0,3.280000000000001,53.95795616044748,104.84,112.17,66.84856753069568,-33.15143246930433,-0.9069053607527735,-0.47454617287648354,-0.01781079387809903,-285610805,1.0
369,JPM,1559710800000,110.13,110.38,108.6376,109.86,8340484,0.39000000000000057,0.0,0.39000000000000057,56.09122102125592,104.84,112.17,72.16916780354697,-27.830832196453027,-0.7392947728483961,-0.5274958928708661,-0.006226312939902501,-277270321,1.0
370,JPM,1559797200000,110.37,110.87,108.9307,110.15,8726664,0.2400000000000091,0.0,0.2400000000000091,57.48977156312296,104.84,111.92,78.10734463276839,-21.892655367231605,-0.5804056253694796,-0.5380778393705888,0.01592415316642115,-268543657,1.0
371,JPM,1559883600000,109.16,110.02,108.96,109.7,10618932,-1.210000000000008,1.210000000000008,0.0,48.50276012630616,104.84,111.92,61.01694915254229,-38.983050847457704,-0.5458297334658226,-0.5396282181896356,-0.005013216662109188,-279162589,-1.0
372,JPM,1560142800000,110.34,111.21,110.215,110.75,11380602,1.1800000000000068,0.0,1.1800000000000068,56.206157592061565,104.84,111.92,77.68361581920907,-22.31638418079094,-0.4183890234733241,-0.5153803792463733,0.016771102100995305,-267781987,1.0
373,JPM,1560229200000,110.68,111.57,110.37,110.82,9847999,0.3400000000000034,0.0,0.3400000000000034,58.28096333707798,104.84,111.79,84.02877697841728,-15.97122302158272,-0.2866518401632874,-0.46963467142975607,0.022731472925522134,-257933988,1.0
374,JPM,1560315600000,109.27,110.9,108.89,110.7,9670511,-1.4100000000000108,1.4100000000000108,0.0,47.510344183397564,104.84,111.57,65.82466567607726,-34.17533432392275,-0.29265089209798134,-0.43423791556340113,0.020642630300765852,-267604499,-1.0
375,JPM,1560402000000,109.54,110.16,109.05,109.46,8406903,0.27000000000001023,0.0,0.27000000000001023,49.56954814746183,104.84,111.57,69.83655274888574,-30.163447251114267,-0.27247748957275064,-0.40188583036527104,0.03378633446583623,-259197596,1.0
376,JPM,1560488400000,109.82,110.3027,108.63,109.57,9077685,0.2799999999999869,0.0,0.2799999999999869,51.830741875169,104.84,111.57,73.99702823179788,-26.002971768202123,-0.2312307783114278,-0.36775481995450243,0.03156114972759716,-250119911,1.0
377,JPM,1560747600000,109.22,110.37,109.06,109.7,8128583,-0.5999999999999943,0.5999999999999943,0.0,46.658092744181,104.84,111.57,65.08172362555725,-34.91827637444276,-0.2441431181686653,-0.343032479597335,-0.004738472753781586,-258248494,-1.0
378,JPM,1560834000000,110.71,111.405,108.98,109.01,11057340,1.4899999999999949,0.0,1.4899999999999949,58.519845883672396,104.84,111.57,87.22139673105497,-12.778603268945032,-0.1326169671375368,-0.3009493771053754,0.005266503223463115,-247191154,1.0
379,JPM,1560920400000,109.91,111.59,109.695,110.82,13126542,-0.7999999999999972,0.7999999999999972,0.0,51.43413529648987,104.84,111.59,75.111111111111,-24.888888888888992,-0.10754528792924134,-0.2622685592701486,-0.0041677992208027925,-260317696,-1.0
380,JPM,1561006800000,110.19,111.085,109.0331,110.88,13638199,0.28000000000000114,0.0,0.28000000000000114,53.69822598280119,105.3,111.59,77.74244833068356,-22.257551669316445,-0.0643404647554604,-0.22268294036721092,0.009435690729204804,-246679497,1.0
381,JPM,1561093200000,109.44,111.67,109.09,110.19,27089546,-0.75,0.75,0.0,46.935588613799304,107.13,111.67,50.88105726872245,-49.118942731277556,-0.0895863672289181,-0.19606362573955236,-0.008156606851549841,-273769043,-1.0
382,JPM,1561352400000,108.66,109.77,108.535,109.28,13039577,-0.7800000000000011,0.7800000000000011,0.0,40.77365454890462,108.535,111.67,3.987240829346086,-96.01275917065392,-0.17056721540922126,-0.19096434367348616,-0.018250813155041623,-286808620,-1.0
383,JPM,1561438800000,107.76,108.98,107.67,108.68,18660111,-0.8999999999999915,0.8999999999999915,0.0,34.70725681129656,107.67,111.67,2.2500000000000853,-97.74999999999991,-0.3038648347480972,-0.21354444188840843,-0.013818980507000922,-305468731,-1.0
384,JPM,1561525200000,108.48,109.31,108.16,108.3,10324609,0.7199999999999989,0.0,0.7199999999999989,42.591584976105345,107.67,111.67,20.250000000000057,-79.74999999999994,-0.34740154693953684,-0.24031586289863416,-0.009676830381595836,-295144122,1.0
385,JPM,1561611600000,108.84,109.55,108.44,108.84,10906607,0.35999999999999943,0.0,0.35999999999999943,46.33049712352097,107.67,111.67,29.250000000000043,-70.74999999999996,-0.3488345659278025,-0.26201960350446785,-0.00892369331633569,-284237515,1.0
386,JPM,1561698000000,111.8,112.43,110.9,111.04,21634683,2.9599999999999937,0.0,2.9599999999999937,66.82734427697227,107.67,112.43,86.76470588235276,-13.235294117647248,-0.10985662278842767,-0.2315870073612598,0.023622047244094446,-262602832,1.0
387,JPM,1561957200000,113.68,114.52,113.08,113.23,12762478,1.8800000000000097,0.0,1.8800000000000097,74.08145464125623,107.67,114.52,87.73722627737241,-12.26277372262759,0.22860024574286797,-0.13954955674043423,0.026826844910125658,-249840354,1.0
388,JPM,1562043600000,113.8,114.2,113.22,113.51,10182625,0.11999999999999034,0.0,0.11999999999999034,74.49227033539458,107.67,114.52,89.48905109489051,-10.510948905109482,0.5007405245551979,-0.011491540481307764,0.035392593940496875,-239657729,1.0
389,JPM,1562130000000,112.82,113.87,112.26,113.34,6849443,-0.980000000000004,0.980000000000004,0.0,64.81205669463671,107.67,114.52,75.18248175182475,-24.817518248175244,0.6300727598121227,0.11682131957737837,0.023867864597513444,-246507172,-1.0
390,JPM,1562302800000,113.49,114.27,112.92,113.51,7929536,0.6700000000000017,0.0,0.6700000000000017,68.08381585778176,107.67,114.52,84.96350364963502,-15.036496350364992,0.7776684112548367,0.2489907379128701,0.03700657894736836,-238577636,1.0
391,JPM,1562562000000,112.87,113.48,112.5,112.96,6917209,-0.6199999999999903,0.6199999999999903,0.0,61.93504002747853,107.67,114.52,75.91240875912419,-24.08759124087581,0.834985022370887,0.36618959480447355,0.03874470826431087,-245494845,-1.0
392,JPM,1562648400000,113.35,113.49,112.1503,112.28,8947322,0.47999999999998977,0.0,0.47999999999998977,64.7767009568046,107.67,114.52,82.91970802919704,-17.080291970802957,0.9086662986313883,0.4746849355698566,0.05187453600593894,-236547523,1.0
393,JPM,1562734800000,113.02,113.83,112.74,113.37,9242253,-0.3299999999999983,0.3299999999999983,0.0,61.15510336685682,107.67,114.52,78.10218978102188,-21.89781021897812,0.9297138364578927,0.5656907157474639,0.0418510324483774,-245789776,-1.0
394,JPM,1562821200000,114.1,114.355,113.12,113.37,11595170,1.0799999999999983,0.0,1.0799999999999983,67.92659256762192,107.67,114.52,93.8686131386861,-6.131386861313898,1.021762889325288,0.6569051504630288,0.04832782065417107,-234194606,1.0
395,JPM,1562907600000,115.3,115.35,113.93,114.13,10783395,1.2000000000000028,0.0,1.2000000000000028,73.78528564767318,107.67,115.35,99.34895833333337,-0.6510416666666302,1.1779635673345012,0.7611168338373233,0.03130590339892669,-223411211,1.0
396,JPM,1563166800000,113.9,115.57,113.53,115.54,12946597,-1.3999999999999915,1.3999999999999915,0.0,59.22269857347796,107.67,115.57,78.86075949367101,-21.139240506328978,1.175238017998879,0.8439410706696346,0.0019352568613653087,-236357808,-1.0
397,JPM,1563253200000,115.12,115.5,112.92,113.48,16944998,1.2199999999999989,0.0,1.2199999999999989,65.974932366577,108.16,115.57,93.92712550607303,-6.0728744939269745,1.2570315275735453,0.9265591620504168,0.011599297012302445,-219412810,1.0
398,JPM,1563339600000,113.99,114.94,113.73,114.43,13120924,-1.1300000000000097,1.1300000000000097,0.0,56.0549775865998,108.44,115.57,77.84011220196354,-22.159887798036458,1.2166471658149618,0.9845767628033257,0.010370501684098477,-232533734,-1.0
399,JPM,1563426000000,114.67,115.07,113.55,113.93,9400654,0.6800000000000068,0.0,0.6800000000000068,60.20921767710372,110.9,115.57,80.72805139186309,-19.271948608136913,1.2253870856244333,1.0327388273675475,0.010397391840690773,-223133080,1.0
400,JPM,1563512400000,113.54,115.12,113.4,114.89,10402772,-1.1299999999999955,1.1299999999999955,0.0,50.97038226183392,112.1503,115.57,40.63806766675464,-59.36193233324537,1.1281276258099382,1.0518165870560257,0.005936032603880648,-233535852,-1.0
401,JPM,1563771600000,114.27,114.45,112.77,112.91,9061487,0.7299999999999898,0.0,0.7299999999999898,56.00274721661454,112.1503,115.57,61.984969441763894,-38.01503055823611,1.0973046572850649,1.0609142011018335,0.008116453462726048,-224474365,1.0
402,JPM,1563858000000,116.36,116.45,114.82,114.88,12752167,2.0900000000000034,0.0,2.0900000000000034,67.14334131232025,112.1503,116.45,97.90683070911916,-2.0931692908808377,1.227374358215343,1.0942062325245354,0.02955229162980011,-211722198,1.0
403,JPM,1563944400000,116.83,116.88,115.52,115.58,10011034,0.46999999999999886,0.0,0.46999999999999886,69.16901580113169,112.1503,116.88,98.94285049791748,-1.057149502082526,1.352786524377649,1.145922290895158,0.023926380368098243,-201711164,1.0
404,JPM,1564030800000,115.71,117.24,115.315,116.89,10138368,-1.1200000000000045,1.1200000000000045,0.0,59.14321122707513,112.1503,117.24,69.93928915260226,-30.060710847397747,1.3462828195261238,1.1859943966213513,0.003555941023417164,-211849532,-1.0
405,JPM,1564117200000,116.22,116.51,115.53,115.77,12800364,0.5100000000000051,0.0,0.5100000000000051,62.0345331153745,112.1503,117.24,79.95952610173492,-20.04047389826507,1.3665288306022916,1.2221012834175395,0.020368744512730297,-199049168,1.0
406,JPM,1564376400000,115.85,117.18,115.79,116.46,8500370,-0.37000000000000455,0.37000000000000455,0.0,58.565160039777844,112.74,117.24,69.1111111111111,-30.8888888888889,1.3373024423502642,1.2451415152040846,0.006341209173036821,-207549538,-1.0
407,JPM,1564462800000,115.59,116.08,114.76,115.19,7121146,-0.2599999999999909,0.2599999999999909,0.0,56.0246765640676,112.77,117.24,63.087248322147836,-36.91275167785217,1.2784236203026609,1.2517979362237999,0.014036318975348738,-214670684,-1.0
408,JPM,1564549200000,116.0,116.18,114.86,116.1,13647968,0.4099999999999966,0.0,0.4099999999999966,59.24168141068137,112.77,117.24,72.25950782997774,-27.740492170022264,1.2504311116294247,1.251524571304925,0.01159850004360341,-201022716,1.0
409,JPM,1564635600000,112.94,116.8,112.595,115.33,15664530,-3.0600000000000023,3.0600000000000023,0.0,36.344990903628634,112.595,117.24,7.427341227125924,-92.57265877287408,0.9701471676645781,1.1952490905768558,-0.005284481240091621,-216687246,-1.0
410,JPM,1564722000000,112.93,113.43,111.4,112.4,11025527,-0.009999999999990905,0.009999999999990905,0.0,36.29209964370755,111.4,117.24,26.198630136986367,-73.80136986301363,0.7386979560947964,1.103938863680444,-0.011726612409206139,-227712773,-1.0
411,JPM,1564981200000,109.57,110.98,108.265,110.79,15855328,-3.3600000000000136,3.3600000000000136,0.0,23.201826533310154,108.265,117.24,14.540389972144773,-85.45961002785522,0.2809107053652724,0.9393332320174096,-0.05835338604331386,-243568101,-1.0
412,JPM,1565067600000,110.43,110.5,108.34,110.05,10203487,0.8600000000000136,0.0,0.8600000000000136,30.595054706942378,108.265,117.24,24.12256267409479,-75.8774373259052,-0.012351792560863828,0.748996227101755,-0.054780450226825206,-233364614,1.0
413,JPM,1565154000000,108.03,108.28,105.94,108.0,17320865,-2.4000000000000057,2.4000000000000057,0.0,23.355229828893755,105.94,117.24,18.495575221238973,-81.50442477876103,-0.4334280881718371,0.5125113640470366,-0.06637282862328231,-250685479,-1.0
414,JPM,1565240400000,109.86,110.08,108.72,109.05,10903331,1.8299999999999983,0.0,1.8299999999999983,36.56243907756262,105.94,117.24,34.690265486725686,-65.30973451327431,-0.6124089113636444,0.2875273089649003,-0.05472379969024266,-239782148,1.0
415,JPM,1565326800000,109.74,110.445,108.29,109.35,9980834,-0.12000000000000455,0.12000000000000455,0.0,36.09187792038732,105.94,117.24,33.62831858407078,-66.37168141592922,-0.755229682680735,0.0789759106357732,-0.05274061286145881,-249762982,-1.0
416,JPM,1565586000000,107.68,108.5146,107.21,108.44,9389209,-2.059999999999988,2.059999999999988,0.0,28.760155336922196,105.94,117.24,15.39823008849566,-84.60176991150435,-1.0228501766450364,-0.1413893068203888,-0.06843152521844442,-259152191,-1.0
417,JPM,1565672400000,109.34,110.33,107.03,107.95,12236560,1.6599999999999966,0.0,1.6599999999999966,40.078172947194545,105.94,117.24,30.088495575221298,-69.9115044247787,-1.0884462881367938,-0.3308007030836699,-0.057413793103448296,-246915631,1.0
418,JPM,1565758800000,104.8,106.91,104.45,106.3,19491849,-4.540000000000006,4.540000000000006,0.0,26.69471452766915,104.45,117.18,2.7494108405341255,-97.25058915946587,-1.4896005488424606,-0.562560672235428,-0.07207366743403576,-266407480,-1.0
419,JPM,1565845200000,105.2,106.38,104.34,104.82,13365567,0.4000000000000057,0.0,0.4000000000000057,29.10156512176532,104.34,117.18,6.697819314641738,-93.30218068535827,-1.7550108608045178,-0.801050709949246,-0.06844948197998768,-253041913,1.0
420,JPM,1565931600000,107.72,107.98,105.87,106.37,11830550,2.519999999999996,0.0,2.519999999999996,42.76256436225129,104.34,116.8,27.126805778491146,-72.87319422150885,-1.7419276481160608,-0.989226097582609,-0.016884183626905136,-241211363,1.0
421,JPM,1566190800000,108.69,109.75,108.415,109.63,8265570,0.9699999999999989,0.0,0.9699999999999989,47.2747175387499,104.34,116.8,34.91171749598713,-65.08828250401287,-1.634447323096694,-1.1182703426854261,-0.015756587883727358,-232945793,1.0
422,JPM,1566277200000,107.31,108.44,107.24,107.85,8376105,-1.3799999999999955,1.3799999999999955,0.0,41.857986643713225,104.34,116.8,23.836276083467098,-76.1637239165329,-1.6416983810092205,-1.222955950350185,-0.006664815329075258,-241321898,-1.0
423,JPM,1566363600000,107.61,108.43,107.445,108.21,8189648,0.29999999999999716,0.0,0.29999999999999716,43.48234747131989,104.34,113.43,35.97359735973591,-64.02640264026408,-1.6047389718978309,-1.2993125546597142,-0.0204806116876024,-233132250,1.0
424,JPM,1566450000000,108.72,109.265,107.93,108.37,9343395,1.1099999999999994,0.0,1.1099999999999994,49.50503271937066,104.34,110.98,65.96385542168667,-34.036144578313326,-1.4689475377291075,-1.333239551273593,-0.009294696555494752,-223788855,1.0
425,JPM,1566536400000,106.02,108.78,105.11,108.0,14764096,-2.700000000000003,2.700000000000003,0.0,38.10761404169669,104.34,110.5,27.272727272727167,-72.72727272727283,-1.5612027099589767,-1.37883218301067,-0.01541604754829129,-238552951,-1.0
426,JPM,1566795600000,106.87,106.99,106.01,106.62,8211955,0.8500000000000085,0.0,0.8500000000000085,42.88418868423268,104.34,110.445,41.441441441441526,-58.558558558558474,-1.5478846516210325,-1.4126426767327427,-0.0225900859703676,-230340996,1.0
427,JPM,1566882000000,105.74,107.56,104.84,107.35,14335951,-1.1300000000000097,1.1300000000000097,0.0,38.34483855778511,104.34,110.445,22.93202293202283,-77.06797706797717,-1.6099530144431924,-1.4521047442748327,0.008969465648855035,-244676947,-1.0
428,JPM,1566968400000,106.8,107.21,105.04,105.08,10593762,1.0600000000000023,0.0,1.0600000000000023,44.682569670435065,104.34,110.445,40.29484029484026,-59.70515970515974,-1.5556766261763073,-1.4728191206551278,0.015209125475285079,-234083185,1.0
429,JPM,1567054800000,109.22,109.89,108.02,108.14,10002439,2.4200000000000017,0.0,2.4200000000000017,56.46981431842377,104.34,110.33,81.46911519198665,-18.53088480801336,-1.3023754487458348,-1.4387303862732694,0.013924990716672747,-224080746,1.0
430,JPM,1567141200000,109.86,110.56,109.47,109.84,10170346,0.6400000000000006,0.0,0.6400000000000006,59.127444843247616,104.34,110.56,88.74598070739546,-11.254019292604548,-1.0380240937932257,-1.3585891277772608,0.010764559757107328,-213910400,1.0
431,JPM,1567486800000,108.56,108.99,107.3167,108.98,9869174,-1.2999999999999972,1.2999999999999972,0.0,51.72588434713527,104.34,110.56,67.84565916398714,-32.15434083601287,-0.9227855781603296,-1.2714284178538746,0.011648495014444205,-223779574,-1.0
432,JPM,1567573200000,109.87,110.22,108.56,109.45,6944055,1.3100000000000023,0.0,1.3100000000000023,57.859415638925185,104.34,110.56,88.9067524115756,-11.093247588424402,-0.7174814923720731,-1.1606390327575145,0.021001765635163983,-216835519,1.0
433,JPM,1567659600000,112.37,113.72,111.2,111.25,13226615,2.5,0.0,2.5,67.0719461929607,104.84,113.72,84.79729729729736,-15.202702702702647,-0.34902408621461234,-0.998316043448934,0.0335724797645327,-203608904,1.0
434,JPM,1567746000000,112.61,112.98,111.9636,112.66,7836735,0.23999999999999488,0.0,0.23999999999999488,67.85047045145683,104.84,113.72,87.5,-12.5,-0.03722384963866432,-0.8060976046868802,0.06215808338049422,-195772169,1.0
435,JPM,1568005200000,115.4,116.055,113.6,113.71,13985144,2.7900000000000063,0.0,2.7900000000000063,75.59135548630704,104.84,116.055,94.15960766830138,-5.840392331698626,0.43005239097938386,-0.5588676055536274,0.07981659960699927,-181787025,1.0
436,JPM,1568091600000,116.87,117.27,115.7275,116.3,14333096,1.4699999999999989,0.0,1.4699999999999989,78.70803894900742,104.84,117.27,96.7819790828641,-3.218020917135895,0.9085160850137157,-0.26539086744015866,0.10525818044259516,-167453929,1.0
437,JPM,1568178000000,117.19,117.2,115.38,116.89,9919217,0.3199999999999932,0.0,0.3199999999999932,79.36969934679306,104.84,117.27,99.35639581657281,-0.643604183427179,1.2985544084307605,0.04739818773402528,0.09728464419475658,-157534712,1.0
438,JPM,1568264400000,117.91,118.473,115.92,116.55,12283450,0.7199999999999989,0.0,0.7199999999999989,80.90983700491213,104.84,118.473,95.87031467762046,-4.129685322379539,1.6467775460545795,0.36727405939813623,0.07956418238417862,-145251262,1.0
439,JPM,1568350800000,120.23,120.4,118.75,119.0,16257246,2.3200000000000074,0.0,2.3200000000000074,85.05732941890763,104.84,120.4,98.90745501285346,-1.0925449871465402,2.0859064710184896,0.7110005417222071,0.09439286364463872,-128994016,1.0
440,JPM,1568610000000,119.16,119.8699,118.38,118.9,11993932,-1.0700000000000074,1.0700000000000074,0.0,76.24244761353657,104.84,120.4,92.03084832904878,-7.969151670951215,2.3208262102806145,1.0329656754338887,0.09764185703758277,-140987948,-1.0
441,JPM,1568696400000,118.57,118.61,117.24,118.42,10819727,-0.5900000000000034,0.5900000000000034,0.0,71.52630752563763,105.04,120.4,88.08593749999993,-11.914062500000082,2.4313664480468873,1.3126458299564885,0.07918449076180933,-151807675,-1.0
442,JPM,1568782800000,119.76,120.08,117.75,118.32,10716320,1.190000000000012,0.0,1.190000000000012,75.10947264253413,107.3167,120.4,95.10826779176507,-4.891732208234926,2.5851929426153646,1.567155252488264,0.06576488386580048,-141091355,1.0
443,JPM,1568869200000,119.38,120.3396,119.09,119.7,9460470,-0.38000000000000966,0.38000000000000966,0.0,71.78120445018607,107.3167,120.4,92.20380179312552,-7.796198206874486,2.6459379974184145,1.7829118014742944,0.06011899476067839,-150551825,-1.0
444,JPM,1568955600000,118.9,120.34,118.87,119.74,22076823,-0.47999999999998977,0.47999999999998977,0.0,67.42648981934722,107.3167,120.4,88.5350026369494,-11.4649973630506,2.6250865389601756,1.9513467489714706,0.030329289428076223,-172628648,-1.0
445,JPM,1569214800000,118.88,119.12,117.68,117.78,9184038,-0.020000000000010232,0.020000000000010232,0.0,67.23040167788845,108.56,120.4,87.16216216216208,-12.83783783783792,2.577238968499074,2.0765251928769914,0.017198596731410998,-181812686,-1.0
446,JPM,1569301200000,117.33,119.26,117.04,118.75,11851899,-1.5499999999999972,1.5499999999999972,0.0,53.35500131204984,111.2,120.4,66.63043478260863,-33.369565217391376,2.3867345874426746,2.138567071790128,0.0011946411809882207,-193664585,-1.0
447,JPM,1569387600000,118.0,118.36,117.12,117.27,10269021,0.6700000000000017,0.0,0.6700000000000017,57.708368212329795,111.9636,120.4,71.55184675928116,-28.448153240718838,2.263727057128463,2.163599068857795,0.0007632940378254904,-183395564,1.0
448,JPM,1569474000000,117.03,118.05,116.95,117.88,9920613,-0.9699999999999989,0.9699999999999989,0.0,49.924759345834744,113.6,120.4,50.44117647058825,-49.55882352941175,2.064177259222703,2.1437147069307767,-0.026615653331115374,-193316177,-1.0
449,JPM,1569560400000,117.72,118.635,117.28,117.96,10207958,0.6899999999999977,0.0,0.6899999999999977,54.91580758907965,115.38,120.4,46.613545816733044,-53.38645418326696,1.9393541724393089,2.102842600032483,-0.012084592145015116,-183108219,1.0
450,JPM,1569819600000,117.69,118.77,117.215,118.36,9800755,-0.030000000000001137,0.030000000000001137,0.0,54.64258285445031,115.38,120.4,46.01593625498003,-53.984063745019974,1.8170642420826368,2.045686928442514,-0.007421776165977834,-192908974,-1.0
451,JPM,1569906000000,115.55,119.0,115.41,118.4,11328624,-2.1400000000000006,2.1400000000000006,0.0,38.76711465939657,115.41,120.4,2.805611222444896,-97.1943887775551,1.5298335075629268,1.9425162442665964,-0.0351536406145625,-204237598,-1.0
452,JPM,1569992400000,113.25,114.9,112.93,114.81,12630337,-2.299999999999997,2.299999999999997,0.0,28.499065978713077,112.93,120.4,4.283801874163229,-95.71619812583677,1.1038853992347981,1.7747900752602368,-0.05134863461216277,-216867935,-1.0
453,JPM,1570078800000,112.19,112.91,110.52,112.27,13102112,-1.0600000000000023,1.0600000000000023,0.0,24.980600812902196,110.52,120.34,17.006109979633404,-82.99389002036659,0.6730270761944013,1.5544374754470698,-0.056433978132884866,-229970047,-1.0
454,JPM,1570165200000,114.62,114.94,112.27,112.34,9622741,2.430000000000007,0.0,2.430000000000007,43.44842235197414,110.52,120.34,41.75152749490841,-58.2484725050916,0.5216363435993117,1.3478772490775184,-0.0358344549125168,-220347306,1.0
455,JPM,1570424400000,114.37,115.5,114.07,114.19,6816951,-0.25,0.25,0.0,42.21478279033307,110.52,120.34,39.205702647657894,-60.7942973523421,0.3771377771091551,1.1537293546838459,-0.02522798943151794,-227164257,-1.0
456,JPM,1570510800000,111.82,113.06,111.66,113.06,11588324,-2.5500000000000114,2.5500000000000114,0.0,31.641325346371545,110.52,120.34,13.238289205702609,-86.76171079429739,0.05620997969253949,0.9342254796855846,-0.05237288135593221,-238752581,-1.0
457,JPM,1570597200000,112.63,113.16,112.07,112.67,7339861,0.8100000000000023,0.0,0.8100000000000023,37.38904450039647,110.52,120.34,21.486761710794276,-78.51323828920572,-0.1312543627813625,0.7211295111921951,-0.03759719729983768,-231412720,1.0
458,JPM,1570683600000,114.21,115.4,113.0,113.14,11388900,1.5799999999999983,0.0,1.5799999999999983,47.35230030384571,110.52,119.26,42.21967963386721,-57.7803203661328,-0.1505924731209518,0.5467851143295658,-0.02981651376146799,-220023820,1.0
459,JPM,1570770000000,116.14,117.99,115.865,116.03,15193768,1.9300000000000068,0.0,1.9300000000000068,56.99716547824427,110.52,119.26,64.3020594965675,-35.697940503432505,-0.01006714677026821,0.43541466210959895,-0.013170192879598974,-204830052,1.0
460,JPM,1571029200000,116.45,116.87,115.66,115.85,8878537,0.3100000000000023,0.0,0.3100000000000023,58.409266073775456,110.52,119.0,69.92924528301891,-30.070754716981085,0.12487511343918811,0.3733067523755168,0.007788836001730859,-195951515,1.0
461,JPM,1571115600000,119.96,121.59,117.87,118.85,30522338,3.509999999999991,0.0,3.509999999999991,70.89531004125686,110.52,121.59,85.2755194218608,-14.724480578139193,0.5091760282649602,0.40048060755340553,0.05924944812362032,-165429177,1.0
462,JPM,1571202000000,119.68,120.62,119.38,119.96,11632039,-0.2799999999999869,0.2799999999999869,0.0,68.98894271203937,110.52,121.59,82.74616079494133,-17.253839205058675,0.7821277304417009,0.4768100321310647,0.06676174347089758,-177061216,-1.0
463,JPM,1571288400000,120.35,121.57,119.88,120.75,11064912,0.6699999999999875,0.0,0.6699999999999875,71.13216847269005,110.52,121.59,88.79855465221311,-11.201445347786885,1.0405129360737106,0.589550612919594,0.04999127551910654,-165996304,1.0
464,JPM,1571374800000,120.56,121.02,119.86,120.0,10418383,0.21000000000000796,0.0,0.21000000000000796,71.83610968291087,110.52,121.59,90.69557362240289,-9.304426377597114,1.247845926969731,0.7212096757296215,0.05412258459386199,-155577921,1.0
465,JPM,1571634000000,123.55,123.77,121.99,122.05,13272678,2.989999999999995,0.0,2.989999999999995,79.89170017815617,110.52,123.77,98.33962264150944,-1.6603773584905575,1.6345843565666627,0.9038846118970297,0.10490073332140937,-142305243,1.0
466,JPM,1571720400000,124.79,125.1,123.12,123.45,12657085,1.240000000000009,0.0,1.240000000000009,82.31255253285495,110.52,125.1,97.87379972565165,-2.126200274348341,2.017874187657526,1.1266825270491292,0.1079641303382759,-129648158,1.0
467,JPM,1571806800000,125.12,125.15,124.165,124.2,9397328,0.3299999999999983,0.0,0.3299999999999983,82.94312160472597,111.66,125.15,99.77761304670125,-0.22238695329874808,2.321501557456287,1.3656463331305608,0.09552578583311444,-120250830,1.0
468,JPM,1571893200000,125.03,125.66,124.07,125.29,8057164,-0.09000000000000341,0.09000000000000341,0.0,82.02292792298762,111.66,125.66,95.50000000000003,-4.499999999999967,2.5257509035099304,1.597667247206435,0.07654554847597717,-128307994,-1.0
469,JPM,1571979600000,126.03,126.65,124.75,125.0,9055690,1.0,0.0,1.0,84.26148431500305,111.66,126.65,95.86390927284853,-4.136090727151462,2.736763913625907,1.8254865804903295,0.08226706741090606,-119252304,1.0
470,JPM,1572238800000,126.51,127.21,126.4,126.57,9522184,0.480000000000004,0.0,0.480000000000004,85.27688604106359,112.07,127.21,95.37648612945846,-4.623513870541537,2.9091899025928285,2.0422272449108294,0.05460153384461508,-109730120,1.0
471,JPM,1572325200000,126.43,127.42,125.94,126.06,9797283,-0.0799999999999983,0.0799999999999983,0.0,84.23181231958893,113.0,127.42,93.13453536754511,-6.865464632454888,3.0047465617253977,2.2347311082737433,0.05640040106951871,-119527403,-1.0
472,JPM,1572411600000,125.73,126.26,124.916,126.05,8513704,-0.7000000000000028,0.7000000000000028,0.0,74.95740630524739,115.66,127.42,85.6292517006803,-14.370748299319702,2.989530308205616,2.385690948260118,0.04470294972995448,-128041107,-1.0
473,JPM,1572498000000,124.92,125.73,123.86,125.49,11589074,-0.8100000000000023,0.8100000000000023,0.0,65.35030319389648,115.66,127.42,78.74149659863946,-21.258503401360535,2.878924635981207,2.484337685804336,0.036164565361645584,-139630181,-1.0
474,JPM,1572584400000,127.8,127.9852,126.02,126.2,11682642,2.8799999999999955,0.0,2.8799999999999955,77.29102912435216,117.87,127.9852,98.16909205947476,-1.8309079405252382,2.989203102062021,2.585310769055873,0.03439902873330625,-127947539,1.0
475,JPM,1572847200000,128.82,129.42,128.5601,129.08,9159871,1.019999999999996,0.0,1.019999999999996,80.09429587994616,119.38,129.42,94.02390438247016,-5.976095617529829,3.122906138426629,2.6928298429300246,0.032294254347303264,-118787668,1.0
476,JPM,1572933600000,129.1,130.3,128.84,129.39,13747635,0.28000000000000114,0.0,0.28000000000000114,80.84331532157711,119.86,130.3,88.50574712643663,-11.494252873563369,3.214406737989492,2.797145221941918,0.03180946291560094,-105040033,1.0
477,JPM,1573020000000,129.3,129.84,128.58,128.69,11231123,0.20000000000001705,0.0,0.20000000000001705,81.41954003166953,119.86,130.3,90.42145593869732,-9.57854406130267,3.2654182420573505,2.890799825965005,0.03415180356714398,-93808910,1.0
478,JPM,1573106400000,130.0,131.29,129.92,130.43,13528925,0.6999999999999886,0.0,0.6999999999999886,83.43212526033618,121.99,131.29,86.1290322580646,-13.870967741935402,3.324012232514434,2.9774423072748912,0.031500436404030774,-80279985,1.0
479,JPM,1573192800000,130.38,130.4,129.25,129.88,9294223,0.37999999999999545,0.0,0.37999999999999545,84.48478742486988,123.12,131.29,88.86168910648718,-11.138310893512827,3.3623521141259403,3.0544242686451013,0.030590467156746515,-70985762,1.0
480,JPM,1573452000000,129.92,130.1,129.35,129.6,8680490,-0.46000000000000796,0.46000000000000796,0.0,77.59831746119346,123.86,131.29,81.5612382234185,-18.438761776581504,3.317377923204745,3.1070149995570304,0.027604207862057972,-79666252,-1.0
481,JPM,1573538400000,129.16,130.62,129.01,129.63,9101912,-0.7599999999999909,0.7599999999999909,0.0,67.16203851303881,123.86,131.29,71.33243606998657,-28.66756393001343,3.1837100764920763,3.12235401494404,0.027280680823987824,-88768164,-1.0
482,JPM,1573624800000,128.48,128.815,127.42,128.13,8098146,-0.6800000000000068,0.6800000000000068,0.0,58.97371342810522,123.86,131.29,62.180349932705184,-37.819650067294816,2.988457945005024,3.095574800956237,0.0284982388728785,-96866310,-1.0
483,JPM,1573711200000,128.6,128.84,127.59,127.72,8483725,0.12000000000000455,0.0,0.12000000000000455,59.96752463979371,123.86,131.29,63.79542395693135,-36.20457604306865,2.8109987770877893,3.0386595961825478,0.0062597809076681,-88382585,1.0
484,JPM,1573797600000,129.53,129.53,128.4,129.23,10163667,0.9300000000000068,0.0,0.9300000000000068,67.09523556510351,123.86,131.29,76.31224764468382,-23.687752355316185,2.7141176765590416,2.973751212257847,0.005511566526936962,-78218918,1.0
485,JPM,1574056800000,130.62,130.65,128.99,129.56,8752503,1.0900000000000034,0.0,1.0900000000000034,73.48068406218735,123.86,131.29,90.98250336473771,-9.01749663526229,2.694235131397633,2.9178479960858046,0.011773818745158815,-69466415,1.0
486,JPM,1574143200000,130.58,131.25,130.18,130.99,8824852,-0.03999999999999204,0.03999999999999204,0.0,72.88181319173192,123.86,131.29,90.44414535666245,-9.555854643337554,2.644763221298021,2.8632310411282482,0.009899458623356505,-78291267,-1.0
487,JPM,1574229600000,129.63,130.62,128.94,130.3,11785284,-0.950000000000017,0.950000000000017,0.0,59.57596398099559,126.02,131.29,68.50094876660346,-31.499051233396543,2.5000799501795257,2.790600822938504,-0.0028461538461538316,-90076551,-1.0
488,JPM,1574316000000,129.93,130.72,129.39,130.0,7705492,0.30000000000001137,0.0,0.30000000000001137,62.097345752560656,127.42,131.29,64.8578811369512,-35.1421188630488,2.3821647953125478,2.708913617413313,-0.0034514496088355884,-82371059,1.0
489,JPM,1574402400000,130.79,131.22,130.1,130.15,8167918,0.8599999999999852,0.0,0.8599999999999852,68.5797198783056,127.42,131.29,87.0801033591731,-12.919896640826906,2.3312379384189086,2.6333784816144323,0.006696428571428603,-74203141,1.0
490,JPM,1574661600000,131.49,132.07,130.865,131.25,10069669,0.700000000000017,0.0,0.700000000000017,72.9281276020038,127.42,132.07,87.52688172043042,-12.473118279569572,2.320611621041621,2.57082510949987,0.01803964075565201,-64133472,1.0
491,JPM,1574748000000,131.67,131.82,130.3573,131.82,10493863,0.1799999999999784,0.0,0.1799999999999784,73.99591349714373,127.42,132.07,91.39784946236546,-8.602150537634547,2.3001994165888675,2.51669997091767,0.02482876712328763,-53639609,1.0
492,JPM,1574834400000,132.06,132.43,131.65,132.29,6609027,0.3900000000000148,0.0,0.3900000000000148,76.32993740609957,127.42,132.43,92.61477045908175,-7.385229540918246,2.289104961059337,2.4711809689460034,0.026905132192846182,-47030582,1.0
493,JPM,1575007200000,131.76,132.41,131.45,131.87,5712035,-0.30000000000001137,0.30000000000001137,0.0,70.69778906102623,127.42,132.43,86.62674650698573,-13.373253493014275,2.230394433666561,2.423023661890115,0.017216088936925722,-52742617,-1.0
494,JPM,1575266400000,131.47,132.74,131.35,132.31,8622886,-0.28999999999999204,0.28999999999999204,0.0,65.32175886997291,127.42,132.74,76.12781954887203,-23.872180451127978,2.135844653701696,2.365587860252431,0.006507426121574067,-61365503,-1.0
495,JPM,1575352800000,129.78,129.96,128.585,129.77,10649454,-1.6899999999999977,1.6899999999999977,0.0,43.2216698909842,127.42,132.74,44.360902255639026,-55.639097744360974,1.9026122659377336,2.272992741389492,-0.006126512482769297,-72014957,-1.0
496,JPM,1575439200000,132.34,132.47,129.99,130.38,10319310,2.5600000000000023,0.0,2.5600000000000023,64.32042990874541,127.59,132.74,92.23300970873777,-7.766990291262238,1.902414671354137,2.198877127382421,0.020905654555272823,-61695647,1.0
497,JPM,1575525600000,133.06,133.31,132.18,132.68,9587878,0.7199999999999989,0.0,0.7199999999999989,68.16004113489585,128.4,133.31,94.90835030549898,-5.091649694501022,1.9380158189441374,2.1467048656947645,0.02408989455860855,-52107769,1.0
498,JPM,1575612000000,135.04,135.78,134.65,134.69,10171252,1.9799999999999898,0.0,1.9799999999999898,76.26481443940496,128.585,135.78,89.71507991660862,-10.28492008339138,2.101771523535234,2.1377181972628585,0.03249483905497352,-41936517,1.0
499,JPM,1575871200000,134.41,135.46,134.41,134.63,8576380,-0.6299999999999955,0.6299999999999955,0.0,69.74679164847156,128.585,135.78,80.9589993050729,-19.041000694927114,2.15586192999794,2.1413469438098747,0.022207011940071464,-50512897,-1.0
500,JPM,1575957600000,134.5,134.77,132.88,133.25,7533000,0.09000000000000341,0.0,0.09000000000000341,70.16707039360118,128.585,135.78,82.20986796386376,-17.79013203613624,2.180851713636855,2.149247897775271,0.021493126756284786,-42979897,1.0
501,JPM,1576044000000,134.18,135.02,134.01,134.29,9012476,-0.3199999999999932,0.3199999999999932,0.0,66.38366737880693,128.585,135.78,77.76233495482981,-22.2376650451702,2.1500505274435397,2.1494084237089246,0.016053309101923485,-51992373,-1.0
502,JPM,1576130400000,138.02,138.47,134.21,134.49,13725737,3.8400000000000034,0.0,3.8400000000000034,80.75309211275533,128.585,138.47,95.4476479514417,-4.552352048558311,2.407741329970804,2.2010750049613006,0.04751062537947792,-38266636,1.0
503,JPM,1576216800000,136.81,138.83,136.22,137.95,10594949,-1.210000000000008,1.210000000000008,0.0,69.89102434434967,128.585,138.83,80.28306490971197,-19.716935090288036,2.4856729692161537,2.2579945978122713,0.04061763139879826,-48861585,-1.0
